,year,school,subject,t_band6,t_male,t_female
0,2013,Dapto High School,15240,1,1,0
1,2013,Dapto High School,15350,1,0,1
2,2013,Dapto High School,15030,1,0,1
3,2013,Dapto High School,15060,2,0,2
4,2013,Galstaun College,15230,1,1,0
5,2013,Frensham School,15240,6,0,6
6,2013,Frensham School,15270,3,0,3
7,2013,Frensham School,15230,3,0,3
8,2013,Frensham School,15190,2,0,2
9,2013,Frensham School,15080,2,0,2
10,2013,Frensham School,15090,2,0,2
11,2013,Frensham School,15320,2,0,2
12,2013,Frensham School,15280,2,0,2
13,2013,Frensham School,15160,2,0,2
14,2013,Frensham School,15680,1,0,1
15,2013,Frensham School,15900,2,0,2
16,2013,Frensham School,15330,3,0,3
17,2013,Frensham School,15400,8,0,8
18,2013,Frensham School,15140,6,0,6
19,2013,Frensham School,15050,2,0,2
20,2013,Frensham School,15290,3,0,3
21,2013,Frensham School,15250,2,0,2
22,2013,Frensham School,15010,3,0,3
23,2013,Meadowbank Education Trust School,15240,3,3,0
24,2013,Meadowbank Education Trust School,15270,2,1,1
25,2013,Meadowbank Education Trust School,15340,15,6,9
26,2013,Meadowbank Education Trust School,15230,15,6,9
27,2013,Meadowbank Education Trust School,15670,2,1,1
28,2013,Meadowbank Education Trust School,15200,14,11,3
29,2013,Meadowbank Education Trust School,27299,4,2,2
30,2013,Meadowbank Education Trust School,15040,5,3,2
31,2013,Meadowbank Education Trust School,26199,3,0,3
32,2013,Meadowbank Education Trust School,15180,2,0,2
33,2013,Meadowbank Education Trust School,15130,2,0,2
34,2013,Meadowbank Education Trust School,15390,2,0,2
35,2013,Dubbo College Senior Campus,15270,1,0,1
36,2013,Dubbo College Senior Campus,15340,1,1,0
37,2013,Dubbo College Senior Campus,15230,2,1,1
38,2013,Dubbo College Senior Campus,15080,1,0,1
39,2013,Dubbo College Senior Campus,15320,3,0,3
40,2013,Dubbo College Senior Campus,15280,1,0,1
41,2013,Dubbo College Senior Campus,15200,2,2,0
42,2013,Dubbo College Senior Campus,15030,2,1,1
43,2013,Dubbo College Senior Campus,26599,1,0,1
44,2013,Dubbo College Senior Campus,15180,2,2,0
45,2013,Dubbo College Senior Campus,15060,1,1,0
46,2013,Dubbo College Senior Campus,15140,1,0,1
47,2013,Dubbo College Senior Campus,15250,1,1,0
48,2013,Dubbo College Senior Campus,15220,5,2,3
49,2013,St Ursula's College,15240,3,0,3
50,2013,St Ursula's College,15270,7,0,7
51,2013,St Ursula's College,26499,1,0,1
52,2013,St Ursula's College,15230,13,0,13
53,2013,St Ursula's College,15090,1,0,1
54,2013,St Ursula's College,15320,3,0,3
55,2013,St Ursula's College,15350,5,0,5
56,2013,St Ursula's College,15380,7,0,7
57,2013,St Ursula's College,15160,3,0,3
58,2013,St Ursula's College,15300,1,0,1
59,2013,St Ursula's College,15110,3,0,3
60,2013,St Ursula's College,15980,1,0,1
61,2013,St Ursula's College,15030,4,0,4
62,2013,St Ursula's College,15370,14,0,14
63,2013,St Ursula's College,15310,2,0,2
64,2013,St Ursula's College,26599,4,0,4
65,2013,St Ursula's College,15400,4,0,4
66,2013,St Ursula's College,15040,9,0,9
67,2013,St Ursula's College,15180,3,0,3
68,2013,St Ursula's College,15060,7,0,7
69,2013,St Ursula's College,15140,14,0,14
70,2013,St Ursula's College,15130,6,0,6
71,2013,St Ursula's College,15050,1,0,1
72,2013,St Ursula's College,15210,3,0,3
73,2013,St Ursula's College,15290,7,0,7
74,2013,St Ursula's College,15220,12,0,12
75,2013,St Ursula's College,15020,1,0,1
76,2013,St Ursula's College,15390,1,0,1
77,2013,Endeavour Sports High School,15230,1,0,1
78,2013,Endeavour Sports High School,15250,1,1,0
79,2013,North Sydney Girls High School,15240,42,3,39
80,2013,North Sydney Girls High School,15270,26,1,25
81,2013,North Sydney Girls High School,15170,5,0,5
82,2013,North Sydney Girls High School,15830,6,0,6
83,2013,North Sydney Girls High School,15720,2,0,2
84,2013,North Sydney Girls High School,15360,4,0,4
85,2013,North Sydney Girls High School,15850,4,0,4
86,2013,North Sydney Girls High School,15320,9,1,8
87,2013,North Sydney Girls High School,15280,5,0,5
88,2013,North Sydney Girls High School,15670,1,0,1
89,2013,North Sydney Girls High School,15350,27,1,26
90,2013,North Sydney Girls High School,15160,53,3,50
91,2013,North Sydney Girls High School,15300,5,0,5
92,2013,North Sydney Girls High School,15110,11,0,11
93,2013,North Sydney Girls High School,15910,4,2,2
94,2013,North Sydney Girls High School,15710,4,0,4
95,2013,North Sydney Girls High School,15680,5,1,4
96,2013,North Sydney Girls High School,15640,1,0,1
97,2013,North Sydney Girls High School,15260,40,4,36
98,2013,North Sydney Girls High School,15900,3,1,2
99,2013,North Sydney Girls High School,15030,12,1,11
100,2013,North Sydney Girls High School,15370,2,0,2
101,2013,North Sydney Girls High School,15310,5,0,5
102,2013,North Sydney Girls High School,15330,9,2,7
103,2013,North Sydney Girls High School,15400,7,1,6
104,2013,North Sydney Girls High School,15885,1,0,1
105,2013,North Sydney Girls High School,15835,1,0,1
106,2013,North Sydney Girls High School,15140,69,3,66
107,2013,North Sydney Girls High School,15050,40,2,38
108,2013,North Sydney Girls High School,15210,13,0,13
109,2013,North Sydney Girls High School,15250,76,6,70
110,2013,North Sydney Girls High School,15690,3,1,2
111,2013,North Sydney Girls High School,15220,2,0,2
112,2013,North Sydney Girls High School,15020,6,0,6
113,2013,Melville High School,15240,1,1,0
114,2013,Melville High School,15340,1,0,1
115,2013,Melville High School,15230,2,0,2
116,2013,Melville High School,15190,1,0,1
117,2013,Melville High School,15360,1,1,0
118,2013,Melville High School,15090,1,0,1
119,2013,Melville High School,15320,2,2,0
120,2013,Melville High School,15200,2,2,0
121,2013,Melville High School,27099,1,0,1
122,2013,Melville High School,26599,2,2,0
123,2013,Melville High School,15330,1,1,0
124,2013,Melville High School,15140,1,1,0
125,2013,Melville High School,15050,1,1,0
126,2013,Melville High School,15290,1,1,0
127,2013,Melville High School,15220,1,0,1
128,2013,St Clair High School,15170,1,0,1
129,2013,St Clair High School,15180,1,0,1
130,2013,Camden Haven High School,15340,1,1,0
131,2013,Camden Haven High School,15230,2,1,1
132,2013,Camden Haven High School,15090,2,0,2
133,2013,Camden Haven High School,15670,1,0,1
134,2013,Camden Haven High School,15200,1,1,0
135,2013,Camden Haven High School,15160,1,0,1
136,2013,Camden Haven High School,15030,1,0,1
137,2013,Camden Haven High School,26599,1,1,0
138,2013,Camden Haven High School,15400,2,0,2
139,2013,Camden Haven High School,15140,1,0,1
140,2013,Camden Haven High School,15020,2,0,2
141,2013,Holy Spirit Catholic College,15270,2,0,2
142,2013,Holy Spirit Catholic College,15340,1,1,0
143,2013,Holy Spirit Catholic College,15230,2,2,0
144,2013,Holy Spirit Catholic College,15090,3,2,1
145,2013,Holy Spirit Catholic College,15320,4,2,2
146,2013,Holy Spirit Catholic College,15380,3,2,1
147,2013,Holy Spirit Catholic College,15030,1,1,0
148,2013,Holy Spirit Catholic College,15370,4,0,4
149,2013,Holy Spirit Catholic College,15400,1,0,1
150,2013,Holy Spirit Catholic College,15040,5,4,1
151,2013,Holy Spirit Catholic College,15220,3,2,1
152,2013,Holy Spirit Catholic College,15020,2,1,1
153,2013,Newington College,15240,7,7,0
154,2013,Newington College,15270,8,8,0
155,2013,Newington College,15170,4,4,0
156,2013,Newington College,15230,3,3,0
157,2013,Newington College,15190,3,3,0
158,2013,Newington College,15080,2,2,0
159,2013,Newington College,15120,1,1,0
160,2013,Newington College,15360,1,1,0
161,2013,Newington College,15090,2,2,0
162,2013,Newington College,15320,5,5,0
163,2013,Newington College,15280,4,4,0
164,2013,Newington College,15380,1,1,0
165,2013,Newington College,15160,7,7,0
166,2013,Newington College,15300,2,2,0
167,2013,Newington College,15110,3,3,0
168,2013,Newington College,15710,1,1,0
169,2013,Newington College,15260,3,2,1
170,2013,Newington College,15980,1,1,0
171,2013,Newington College,15030,4,4,0
172,2013,Newington College,15310,1,1,0
173,2013,Newington College,15990,1,1,0
174,2013,Newington College,15330,7,6,1
175,2013,Newington College,15400,7,7,0
176,2013,Newington College,15040,2,2,0
177,2013,Newington College,15140,9,9,0
178,2013,Newington College,15050,2,1,1
179,2013,Newington College,15210,4,4,0
180,2013,Newington College,15290,3,3,0
181,2013,Newington College,15250,6,5,1
182,2013,Newington College,15220,6,6,0
183,2013,Newington College,15020,8,8,0
184,2013,Young High School,26999,1,0,1
185,2013,Young High School,15230,1,1,0
186,2013,Young High School,15190,1,1,0
187,2013,Young High School,26699,1,1,0
188,2013,Young High School,26599,1,0,1
189,2013,Young High School,15400,1,0,1
190,2013,Young High School,15040,2,1,1
191,2013,Young High School,15290,1,0,1
192,2013,Ingleburn High School,15270,1,0,1
193,2013,St Vincent's College,15240,3,0,3
194,2013,St Vincent's College,15270,6,0,6
195,2013,St Vincent's College,15170,2,0,2
196,2013,St Vincent's College,15080,2,0,2
197,2013,St Vincent's College,15090,4,0,4
198,2013,St Vincent's College,15320,2,0,2
199,2013,St Vincent's College,15280,2,0,2
200,2013,St Vincent's College,15350,1,0,1
201,2013,St Vincent's College,15380,8,0,8
202,2013,St Vincent's College,15160,4,0,4
203,2013,St Vincent's College,15710,1,0,1
204,2013,St Vincent's College,15680,5,0,5
205,2013,St Vincent's College,15030,5,0,5
206,2013,St Vincent's College,15370,6,0,6
207,2013,St Vincent's College,15790,1,0,1
208,2013,St Vincent's College,15330,1,0,1
209,2013,St Vincent's College,15400,9,0,9
210,2013,St Vincent's College,15100,1,0,1
211,2013,St Vincent's College,15040,3,0,3
212,2013,St Vincent's College,15060,2,0,2
213,2013,St Vincent's College,15140,12,0,12
214,2013,St Vincent's College,15050,3,0,3
215,2013,St Vincent's College,15290,1,0,1
216,2013,St Vincent's College,15220,4,0,4
217,2013,St Vincent's College,15020,3,0,3
218,2013,Marist College Pagewood,15240,3,3,0
219,2013,Marist College Pagewood,15230,3,3,0
220,2013,Marist College Pagewood,15160,1,1,0
221,2013,Marist College Pagewood,15370,4,4,0
222,2013,Marist College Pagewood,15040,2,2,0
223,2013,Marist College Pagewood,15800,1,1,0
224,2013,Marist College Pagewood,15140,1,1,0
225,2013,Marist College Pagewood,15210,2,2,0
226,2013,Marist College Pagewood,15250,1,1,0
227,2013,Marist College Pagewood,15020,1,1,0
228,2013,Casino High School,15240,1,1,0
229,2013,Casino High School,15230,1,0,1
230,2013,Casino High School,15200,2,2,0
231,2013,Casino High School,15330,1,1,0
232,2013,Casino High School,15050,1,1,0
233,2013,Casino High School,15290,2,1,1
234,2013,Casino High School,15220,1,0,1
235,2013,Central Coast Grammar School,15240,3,2,1
236,2013,Central Coast Grammar School,15270,1,0,1
237,2013,Central Coast Grammar School,15170,1,0,1
238,2013,Central Coast Grammar School,15230,4,3,1
239,2013,Central Coast Grammar School,15360,1,1,0
240,2013,Central Coast Grammar School,15090,3,2,1
241,2013,Central Coast Grammar School,15320,4,2,2
242,2013,Central Coast Grammar School,15350,10,4,6
243,2013,Central Coast Grammar School,15200,1,1,0
244,2013,Central Coast Grammar School,15160,1,0,1
245,2013,Central Coast Grammar School,15110,2,1,1
246,2013,Central Coast Grammar School,15030,4,2,2
247,2013,Central Coast Grammar School,15370,7,3,4
248,2013,Central Coast Grammar School,26599,2,1,1
249,2013,Central Coast Grammar School,15400,5,1,4
250,2013,Central Coast Grammar School,15040,3,2,1
251,2013,Central Coast Grammar School,15140,17,6,11
252,2013,Central Coast Grammar School,15050,2,1,1
253,2013,Central Coast Grammar School,15290,2,0,2
254,2013,Central Coast Grammar School,15250,1,1,0
255,2013,Central Coast Grammar School,15220,5,2,3
256,2013,Condell Park High School,15240,1,1,0
257,2013,Condell Park High School,15230,1,0,1
258,2013,Condell Park High School,26599,1,0,1
259,2013,Condell Park High School,15510,2,1,1
260,2013,Trinity Catholic College Goulburn,15240,1,0,1
261,2013,Trinity Catholic College Goulburn,15230,2,1,1
262,2013,Trinity Catholic College Goulburn,15120,1,1,0
263,2013,Trinity Catholic College Goulburn,15380,1,0,1
264,2013,Trinity Catholic College Goulburn,15370,2,0,2
265,2013,Trinity Catholic College Goulburn,26599,1,0,1
266,2013,Trinity Catholic College Goulburn,15400,2,0,2
267,2013,Trinity Catholic College Goulburn,15180,1,0,1
268,2013,Trinity Catholic College Goulburn,15140,1,0,1
269,2013,Trinity Catholic College Goulburn,15050,1,0,1
270,2013,Trinity Catholic College Goulburn,15290,1,0,1
271,2013,Trinity Catholic College Goulburn,15020,2,0,2
272,2013,Trinity Catholic College Goulburn,15390,1,0,1
273,2013,Kadina High School,15030,1,0,1
274,2013,Kadina High School,26599,1,0,1
275,2013,Kadina High School,15290,1,1,0
276,2013,Kadina High School,15220,1,0,1
277,2013,Glenaeon Rudolf Steiner School,15280,1,1,0
278,2013,Glenaeon Rudolf Steiner School,15350,1,0,1
279,2013,Glenaeon Rudolf Steiner School,15030,1,1,0
280,2013,Glenaeon Rudolf Steiner School,15400,3,2,1
281,2013,Glenaeon Rudolf Steiner School,15020,2,2,0
282,2013,Gunnedah High School,15320,1,0,1
283,2013,Gunnedah High School,26599,2,0,2
284,2013,Braidwood Central School,26899,1,1,0
285,2013,Braidwood Central School,15320,1,0,1
286,2013,Braidwood Central School,15010,1,1,0
287,2013,Gymea Technology High School,15360,1,1,0
288,2013,Gymea Technology High School,26699,1,1,0
289,2013,Gymea Technology High School,15400,1,1,0
290,2013,Gymea Technology High School,15210,2,2,0
291,2013,Gymea Technology High School,15290,1,1,0
292,2013,Casimir Catholic College,15240,2,1,1
293,2013,Casimir Catholic College,15270,1,1,0
294,2013,Casimir Catholic College,15340,1,1,0
295,2013,Casimir Catholic College,15230,1,0,1
296,2013,Casimir Catholic College,15370,4,1,3
297,2013,Casimir Catholic College,15060,1,0,1
298,2013,Casimir Catholic College,15140,2,1,1
299,2013,Casimir Catholic College,15130,1,0,1
300,2013,Casimir Catholic College,15290,2,1,1
301,2013,Casimir Catholic College,15250,1,1,0
302,2013,Casimir Catholic College,15220,1,1,0
303,2013,Casimir Catholic College,15020,2,1,1
304,2013,Merewether High School,15240,17,10,7
305,2013,Merewether High School,15270,1,0,1
306,2013,Merewether High School,15170,2,0,2
307,2013,Merewether High School,15230,4,4,0
308,2013,Merewether High School,15190,9,3,6
309,2013,Merewether High School,15120,5,4,1
310,2013,Merewether High School,15890,1,0,1
311,2013,Merewether High School,15090,3,0,3
312,2013,Merewether High School,15320,6,0,6
313,2013,Merewether High School,15350,17,1,16
314,2013,Merewether High School,15380,3,1,2
315,2013,Merewether High School,15160,5,0,5
316,2013,Merewether High School,15300,1,0,1
317,2013,Merewether High School,15110,2,2,0
318,2013,Merewether High School,15260,3,2,1
319,2013,Merewether High School,15030,6,1,5
320,2013,Merewether High School,15370,3,1,2
321,2013,Merewether High School,26599,3,1,2
322,2013,Merewether High School,15330,9,4,5
323,2013,Merewether High School,15760,1,0,1
324,2013,Merewether High School,15400,5,0,5
325,2013,Merewether High School,15100,5,1,4
326,2013,Merewether High School,15040,14,12,2
327,2013,Merewether High School,15180,7,0,7
328,2013,Merewether High School,15060,3,1,2
329,2013,Merewether High School,15140,19,3,16
330,2013,Merewether High School,15050,5,2,3
331,2013,Merewether High School,15290,6,3,3
332,2013,Merewether High School,15250,12,6,6
333,2013,Merewether High School,15220,8,2,6
334,2013,Merewether High School,15020,3,0,3
335,2013,Gilroy Catholic College,15240,4,0,4
336,2013,Gilroy Catholic College,15270,2,1,1
337,2013,Gilroy Catholic College,15230,4,4,0
338,2013,Gilroy Catholic College,15080,1,1,0
339,2013,Gilroy Catholic College,16080,1,0,1
340,2013,Gilroy Catholic College,15360,1,1,0
341,2013,Gilroy Catholic College,15320,2,0,2
342,2013,Gilroy Catholic College,15280,2,1,1
343,2013,Gilroy Catholic College,15380,3,1,2
344,2013,Gilroy Catholic College,15160,1,0,1
345,2013,Gilroy Catholic College,15370,18,9,9
346,2013,Gilroy Catholic College,15310,1,1,0
347,2013,Gilroy Catholic College,26599,3,0,3
348,2013,Gilroy Catholic College,15400,4,2,2
349,2013,Gilroy Catholic College,15040,3,1,2
350,2013,Gilroy Catholic College,15180,2,1,1
351,2013,Gilroy Catholic College,15060,2,0,2
352,2013,Gilroy Catholic College,15140,5,2,3
353,2013,Gilroy Catholic College,15130,1,0,1
354,2013,Gilroy Catholic College,15290,1,1,0
355,2013,Gilroy Catholic College,15250,3,3,0
356,2013,Gilroy Catholic College,15220,2,1,1
357,2013,Gilroy Catholic College,15020,9,5,4
358,2013,Oxley College,15240,1,1,0
359,2013,Oxley College,15340,3,1,2
360,2013,Oxley College,15080,3,1,2
361,2013,Oxley College,15120,1,1,0
362,2013,Oxley College,15090,6,2,4
363,2013,Oxley College,15320,1,1,0
364,2013,Oxley College,15160,1,1,0
365,2013,Oxley College,15330,1,1,0
366,2013,Oxley College,15400,2,1,1
367,2013,Oxley College,15040,1,1,0
368,2013,Oxley College,15140,2,0,2
369,2013,Oxley College,15050,1,1,0
370,2013,Oxley College,15290,3,2,1
371,2013,Oxley College,15250,1,1,0
372,2013,Normanhurst Boys High School,15240,50,49,1
373,2013,Normanhurst Boys High School,15270,5,5,0
374,2013,Normanhurst Boys High School,15190,11,11,0
375,2013,Normanhurst Boys High School,15080,1,1,0
376,2013,Normanhurst Boys High School,15830,1,1,0
377,2013,Normanhurst Boys High School,15120,2,2,0
378,2013,Normanhurst Boys High School,15360,2,2,0
379,2013,Normanhurst Boys High School,15850,1,1,0
380,2013,Normanhurst Boys High School,15320,1,1,0
381,2013,Normanhurst Boys High School,15280,4,4,0
382,2013,Normanhurst Boys High School,15350,6,5,1
383,2013,Normanhurst Boys High School,15160,12,12,0
384,2013,Normanhurst Boys High School,15300,5,5,0
385,2013,Normanhurst Boys High School,15110,6,6,0
386,2013,Normanhurst Boys High School,15260,12,12,0
387,2013,Normanhurst Boys High School,15030,5,5,0
388,2013,Normanhurst Boys High School,15310,3,3,0
389,2013,Normanhurst Boys High School,15330,7,7,0
390,2013,Normanhurst Boys High School,15400,1,1,0
391,2013,Normanhurst Boys High School,15040,6,6,0
392,2013,Normanhurst Boys High School,15140,31,31,0
393,2013,Normanhurst Boys High School,15050,13,13,0
394,2013,Normanhurst Boys High School,15210,8,8,0
395,2013,Normanhurst Boys High School,15290,3,3,0
396,2013,Normanhurst Boys High School,15250,43,43,0
397,2013,Normanhurst Boys High School,15220,3,3,0
398,2013,Normanhurst Boys High School,15020,7,7,0
399,2013,Australian Institute of Music,15170,1,1,0
400,2013,Australian Institute of Music,15160,1,1,0
401,2013,Australian Institute of Music,15310,2,1,1
402,2013,Australian Institute of Music,15140,1,1,0
403,2013,Australian Institute of Music,15290,2,1,1
404,2013,Narrandera High School,15240,1,1,0
405,2013,Narrandera High School,15230,3,3,0
406,2013,Narrandera High School,15320,2,1,1
407,2013,Narrandera High School,15030,1,0,1
408,2013,Narrandera High School,15050,1,0,1
409,2013,Narrandera High School,15010,1,0,1
410,2013,Coomealla High School,15240,1,0,1
411,2013,Coomealla High School,15230,2,1,1
412,2013,Coomealla High School,15080,1,1,0
413,2013,Coomealla High School,15060,2,0,2
414,2013,Sydney Girls High School,15240,38,3,35
415,2013,Sydney Girls High School,15270,33,0,33
416,2013,Sydney Girls High School,15170,16,0,16
417,2013,Sydney Girls High School,15830,7,0,7
418,2013,Sydney Girls High School,15120,3,0,3
419,2013,Sydney Girls High School,15090,4,0,4
420,2013,Sydney Girls High School,15850,3,0,3
421,2013,Sydney Girls High School,15280,18,1,17
422,2013,Sydney Girls High School,15160,51,2,49
423,2013,Sydney Girls High School,15300,2,0,2
424,2013,Sydney Girls High School,15110,16,1,15
425,2013,Sydney Girls High School,15910,2,0,2
426,2013,Sydney Girls High School,15710,1,0,1
427,2013,Sydney Girls High School,15680,18,2,16
428,2013,Sydney Girls High School,15260,21,0,21
429,2013,Sydney Girls High School,15900,4,0,4
430,2013,Sydney Girls High School,15030,10,0,10
431,2013,Sydney Girls High School,15310,2,0,2
432,2013,Sydney Girls High School,15330,8,0,8
433,2013,Sydney Girls High School,15400,4,1,3
434,2013,Sydney Girls High School,15555,3,0,3
435,2013,Sydney Girls High School,15140,92,2,90
436,2013,Sydney Girls High School,15050,24,0,24
437,2013,Sydney Girls High School,15210,9,1,8
438,2013,Sydney Girls High School,15250,65,1,64
439,2013,Sydney Girls High School,15690,8,1,7
440,2013,Sydney Girls High School,15220,16,2,14
441,2013,Sydney Girls High School,15020,10,1,9
442,2013,Sydney Girls High School,15390,1,0,1
443,2013,Sydney Girls High School,15700,1,0,1
444,2013,Bass High School,15240,1,1,0
445,2013,Bass High School,15110,1,1,0
446,2013,Bass High School,15140,1,1,0
447,2013,Bass High School,15290,2,2,0
448,2013,Bass High School,15250,1,1,0
449,2013,Holroyd High School,15240,1,1,0
450,2013,Holroyd High School,15260,1,0,1
451,2013,Holroyd High School,15150,1,1,0
452,2013,Holroyd High School,15050,1,0,1
453,2013,Holroyd High School,15250,1,0,1
454,2013,Marist College Eastwood,15240,7,6,1
455,2013,Marist College Eastwood,15270,1,1,0
456,2013,Marist College Eastwood,15230,9,9,0
457,2013,Marist College Eastwood,15380,1,1,0
458,2013,Marist College Eastwood,15160,1,1,0
459,2013,Marist College Eastwood,15260,1,0,1
460,2013,Marist College Eastwood,15030,1,1,0
461,2013,Marist College Eastwood,15370,3,3,0
462,2013,Marist College Eastwood,15040,1,1,0
463,2013,Marist College Eastwood,15140,1,1,0
464,2013,Marist College Eastwood,15250,3,2,1
465,2013,Marist College Eastwood,15220,1,1,0
466,2013,Marist College Eastwood,15020,1,1,0
467,2013,Jamison High School,15230,3,1,2
468,2013,Jamison High School,15260,1,1,0
469,2013,Jamison High School,26599,2,0,2
470,2013,Jamison High School,15060,2,0,2
471,2013,Jamison High School,15290,4,1,3
472,2013,Jamison High School,15250,1,1,0
473,2013,Rooty Hill High School,15350,1,0,1
474,2013,Rooty Hill High School,15160,1,0,1
475,2013,Rooty Hill High School,15030,1,0,1
476,2013,Rooty Hill High School,15400,1,0,1
477,2013,Rooty Hill High School,15210,1,0,1
478,2013,Rooty Hill High School,15220,1,0,1
479,2013,Terrigal High School,15240,2,2,0
480,2013,Terrigal High School,15230,1,0,1
481,2013,Terrigal High School,15120,1,1,0
482,2013,Terrigal High School,15070,5,0,5
483,2013,Terrigal High School,15090,2,0,2
484,2013,Terrigal High School,15320,3,1,2
485,2013,Terrigal High School,15350,1,0,1
486,2013,Terrigal High School,15000,1,1,0
487,2013,Terrigal High School,15030,2,1,1
488,2013,Terrigal High School,26599,1,1,0
489,2013,Terrigal High School,15400,5,0,5
490,2013,Terrigal High School,15040,2,2,0
491,2013,Terrigal High School,15180,4,0,4
492,2013,Terrigal High School,15060,4,0,4
493,2013,Terrigal High School,15140,3,1,2
494,2013,Terrigal High School,15290,4,2,2
495,2013,Terrigal High School,15020,2,0,2
496,2013,Terrigal High School,15390,2,0,2
497,2013,Emmanuel Anglican College,15240,1,0,1
498,2013,Emmanuel Anglican College,15170,2,0,2
499,2013,Emmanuel Anglican College,15230,1,0,1
500,2013,Emmanuel Anglican College,15090,2,0,2
501,2013,Emmanuel Anglican College,15290,2,2,0
502,2013,Grafton High School,15240,1,1,0
503,2013,Grafton High School,15230,1,1,0
504,2013,Grafton High School,15280,1,1,0
505,2013,Grafton High School,15200,2,2,0
506,2013,Grafton High School,15000,1,1,0
507,2013,Grafton High School,27099,1,0,1
508,2013,Grafton High School,15030,1,1,0
509,2013,Grafton High School,15100,2,2,0
510,2013,Grafton High School,15020,1,0,1
511,2013,Stella Maris College,15240,3,0,3
512,2013,Stella Maris College,15270,5,0,5
513,2013,Stella Maris College,15340,2,0,2
514,2013,Stella Maris College,15170,3,0,3
515,2013,Stella Maris College,15230,12,0,12
516,2013,Stella Maris College,15080,2,0,2
517,2013,Stella Maris College,15090,1,0,1
518,2013,Stella Maris College,15320,2,0,2
519,2013,Stella Maris College,15280,1,0,1
520,2013,Stella Maris College,15350,3,0,3
521,2013,Stella Maris College,15380,6,0,6
522,2013,Stella Maris College,15820,2,0,2
523,2013,Stella Maris College,15160,1,0,1
524,2013,Stella Maris College,15560,1,0,1
525,2013,Stella Maris College,15260,2,0,2
526,2013,Stella Maris College,27099,2,0,2
527,2013,Stella Maris College,15030,3,0,3
528,2013,Stella Maris College,15370,1,0,1
529,2013,Stella Maris College,15970,1,0,1
530,2013,Stella Maris College,15400,8,0,8
531,2013,Stella Maris College,15100,2,0,2
532,2013,Stella Maris College,15040,4,0,4
533,2013,Stella Maris College,15800,1,0,1
534,2013,Stella Maris College,15140,5,0,5
535,2013,Stella Maris College,15210,1,0,1
536,2013,Stella Maris College,15290,1,0,1
537,2013,Stella Maris College,15250,5,0,5
538,2013,Stella Maris College,15020,3,0,3
539,2013,Stella Maris College,15390,4,0,4
540,2013,Maitland High School,15200,1,1,0
541,2013,Maitland High School,15030,1,0,1
542,2013,Taree High School,15240,2,2,0
543,2013,Taree High School,15340,2,1,1
544,2013,Taree High School,15170,2,0,2
545,2013,Taree High School,15090,2,1,1
546,2013,Taree High School,15320,1,1,0
547,2013,Taree High School,15160,2,1,1
548,2013,Taree High School,26599,1,0,1
549,2013,Taree High School,15140,2,2,0
550,2013,Taree High School,15290,1,1,0
551,2013,Taree High School,15020,2,1,1
552,2013,Hunter River High School,26599,1,0,1
553,2013,Hunter River High School,15060,2,0,2
554,2013,Hills Adventist College,15380,1,0,1
555,2013,Hills Adventist College,15290,1,1,0
556,2013,Roseville College,15240,5,0,5
557,2013,Roseville College,15270,13,0,13
558,2013,Roseville College,15170,5,0,5
559,2013,Roseville College,15230,14,0,14
560,2013,Roseville College,15190,2,0,2
561,2013,Roseville College,15080,7,0,7
562,2013,Roseville College,15090,9,0,9
563,2013,Roseville College,15320,4,0,4
564,2013,Roseville College,15280,4,0,4
565,2013,Roseville College,15160,2,0,2
566,2013,Roseville College,15300,4,2,2
567,2013,Roseville College,15110,2,0,2
568,2013,Roseville College,15680,5,0,5
569,2013,Roseville College,15030,5,0,5
570,2013,Roseville College,15310,4,2,2
571,2013,Roseville College,15330,2,0,2
572,2013,Roseville College,15400,4,0,4
573,2013,Roseville College,15100,2,0,2
574,2013,Roseville College,15040,12,1,11
575,2013,Roseville College,15180,3,0,3
576,2013,Roseville College,15140,16,0,16
577,2013,Roseville College,15050,5,0,5
578,2013,Roseville College,15210,1,0,1
579,2013,Roseville College,15290,4,0,4
580,2013,Roseville College,15250,6,0,6
581,2013,Roseville College,15220,6,0,6
582,2013,Roseville College,15020,9,0,9
583,2013,"De La Salle College, Ashfield",15240,2,2,0
584,2013,"De La Salle College, Ashfield",15230,1,1,0
585,2013,"De La Salle College, Ashfield",15160,1,1,0
586,2013,"De La Salle College, Ashfield",15110,1,1,0
587,2013,"De La Salle College, Ashfield",15370,3,3,0
588,2013,"De La Salle College, Ashfield",15330,1,1,0
589,2013,"De La Salle College, Ashfield",15040,1,1,0
590,2013,"De La Salle College, Ashfield",15050,1,1,0
591,2013,"De La Salle College, Ashfield",15250,1,1,0
592,2013,"De La Salle College, Ashfield",15220,1,1,0
593,2013,Camden High School,15230,3,1,2
594,2013,Camden High School,15190,1,0,1
595,2013,Camden High School,15350,2,0,2
596,2013,Camden High School,15200,1,1,0
597,2013,Camden High School,15310,1,1,0
598,2013,Camden High School,15400,4,1,3
599,2013,Camden High School,15040,3,3,0
600,2013,Camden High School,15060,1,0,1
601,2013,Camden High School,15130,1,0,1
602,2013,Cootamundra High School,15240,1,1,0
603,2013,Cootamundra High School,15170,1,1,0
604,2013,Cootamundra High School,15200,1,1,0
605,2013,Cootamundra High School,15290,1,1,0
606,2013,Gosford High School,15240,40,29,11
607,2013,Gosford High School,15270,7,2,5
608,2013,Gosford High School,15170,2,2,0
609,2013,Gosford High School,15230,15,7,8
610,2013,Gosford High School,15830,1,0,1
611,2013,Gosford High School,15120,1,1,0
612,2013,Gosford High School,15360,2,2,0
613,2013,Gosford High School,15090,3,3,0
614,2013,Gosford High School,15850,1,0,1
615,2013,Gosford High School,15320,3,0,3
616,2013,Gosford High School,15670,4,0,4
617,2013,Gosford High School,15350,12,3,9
618,2013,Gosford High School,15160,6,0,6
619,2013,Gosford High School,15300,4,2,2
620,2013,Gosford High School,15110,2,2,0
621,2013,Gosford High School,15260,14,9,5
622,2013,Gosford High School,15030,7,2,5
623,2013,Gosford High School,15310,3,2,1
624,2013,Gosford High School,15330,10,8,2
625,2013,Gosford High School,15400,4,0,4
626,2013,Gosford High School,15040,5,2,3
627,2013,Gosford High School,15180,2,0,2
628,2013,Gosford High School,15140,35,18,17
629,2013,Gosford High School,15050,18,9,9
630,2013,Gosford High School,15290,2,1,1
631,2013,Gosford High School,15250,33,23,10
632,2013,Gosford High School,15690,1,0,1
633,2013,Gosford High School,15220,4,1,3
634,2013,Gosford High School,15020,7,4,3
635,2013,Gosford High School,15390,2,0,2
636,2013,Gosford High School,15700,5,2,3
637,2013,Barham High School,15230,1,1,0
638,2013,Barham High School,15030,1,1,0
639,2013,Barham High School,15220,1,0,1
640,2013,Sydney Institute - Ultimo Campus,15230,1,0,1
641,2013,Sydney Institute - Ultimo Campus,15320,1,1,0
642,2013,Sydney Institute - Ultimo Campus,15980,1,1,0
643,2013,Sydney Institute - Ultimo Campus,15990,1,1,0
644,2013,Sydney Institute - Ultimo Campus,15330,1,1,0
645,2013,Kingsgrove High School,15240,2,1,1
646,2013,Kingsgrove High School,15270,1,0,1
647,2013,Kingsgrove High School,15340,1,0,1
648,2013,Kingsgrove High School,26999,1,0,1
649,2013,Kingsgrove High School,15230,2,0,2
650,2013,Kingsgrove High School,15280,1,0,1
651,2013,Kingsgrove High School,15200,1,1,0
652,2013,Kingsgrove High School,15160,1,0,1
653,2013,Kingsgrove High School,15260,1,1,0
654,2013,Kingsgrove High School,15030,3,0,3
655,2013,Kingsgrove High School,15970,1,0,1
656,2013,Kingsgrove High School,15400,1,0,1
657,2013,Kingsgrove High School,15040,1,1,0
658,2013,Kingsgrove High School,15060,1,0,1
659,2013,Kingsgrove High School,15140,2,1,1
660,2013,Kingsgrove High School,15050,1,0,1
661,2013,Kingsgrove High School,15210,1,1,0
662,2013,Kingsgrove High School,15250,3,3,0
663,2013,Kingsgrove High School,15220,1,1,0
664,2013,Kingsgrove High School,15020,4,0,4
665,2013,Lucas Heights Community School,15240,3,3,0
666,2013,Lucas Heights Community School,26999,1,0,1
667,2013,Lucas Heights Community School,15170,1,0,1
668,2013,Lucas Heights Community School,15350,2,0,2
669,2013,Lucas Heights Community School,15030,1,1,0
670,2013,Lucas Heights Community School,15330,1,1,0
671,2013,Lucas Heights Community School,15250,2,2,0
672,2013,Lucas Heights Community School,15220,1,1,0
673,2013,Strathfield South High School,15240,1,0,1
674,2013,Strathfield South High School,15350,1,0,1
675,2013,Strathfield South High School,15820,1,0,1
676,2013,Strathfield South High School,15030,1,0,1
677,2013,Strathfield South High School,15250,1,1,0
678,2013,Model Farms High School,15240,2,1,1
679,2013,Model Farms High School,15340,1,1,0
680,2013,Model Farms High School,15170,1,0,1
681,2013,Model Farms High School,15230,2,1,1
682,2013,Model Farms High School,16020,1,1,0
683,2013,Model Farms High School,15030,1,0,1
684,2013,Model Farms High School,26599,1,0,1
685,2013,Model Farms High School,15330,1,1,0
686,2013,Model Farms High School,15400,1,0,1
687,2013,Model Farms High School,15060,2,0,2
688,2013,Model Farms High School,15130,1,0,1
689,2013,Model Farms High School,15050,1,1,0
690,2013,Model Farms High School,15290,3,3,0
691,2013,Model Farms High School,15250,1,1,0
692,2013,Model Farms High School,15020,2,1,1
693,2013,Broken Hill High School,15320,1,0,1
694,2013,Broken Hill High School,15400,1,0,1
695,2013,Glenmore Park High School,15340,2,2,0
696,2013,Glenmore Park High School,15290,1,0,1
697,2013,Southern Cross Distance Education Centre,15230,1,1,0
698,2013,Southern Cross Distance Education Centre,15030,1,0,1
699,2013,Oakhill College Castle Hill,15240,6,5,1
700,2013,Oakhill College Castle Hill,15270,3,2,1
701,2013,Oakhill College Castle Hill,15340,3,0,3
702,2013,Oakhill College Castle Hill,26499,1,0,1
703,2013,Oakhill College Castle Hill,15230,3,3,0
704,2013,Oakhill College Castle Hill,15190,3,3,0
705,2013,Oakhill College Castle Hill,15120,1,1,0
706,2013,Oakhill College Castle Hill,15090,7,6,1
707,2013,Oakhill College Castle Hill,15320,6,4,2
708,2013,Oakhill College Castle Hill,15200,4,4,0
709,2013,Oakhill College Castle Hill,15380,1,0,1
710,2013,Oakhill College Castle Hill,15160,3,3,0
711,2013,Oakhill College Castle Hill,15300,1,1,0
712,2013,Oakhill College Castle Hill,15110,1,1,0
713,2013,Oakhill College Castle Hill,15260,4,4,0
714,2013,Oakhill College Castle Hill,15030,3,3,0
715,2013,Oakhill College Castle Hill,15370,17,12,5
716,2013,Oakhill College Castle Hill,15330,3,3,0
717,2013,Oakhill College Castle Hill,15400,2,0,2
718,2013,Oakhill College Castle Hill,15100,1,0,1
719,2013,Oakhill College Castle Hill,15040,10,9,1
720,2013,Oakhill College Castle Hill,15800,2,2,0
721,2013,Oakhill College Castle Hill,15140,9,7,2
722,2013,Oakhill College Castle Hill,15050,6,5,1
723,2013,Oakhill College Castle Hill,15210,3,3,0
724,2013,Oakhill College Castle Hill,15290,6,5,1
725,2013,Oakhill College Castle Hill,15250,10,9,1
726,2013,Oakhill College Castle Hill,15220,8,8,0
727,2013,Oakhill College Castle Hill,15020,4,2,2
728,2013,Saint Mary MacKillop Colleges Limited,15270,1,1,0
729,2013,Corowa High School,15270,1,0,1
730,2013,Corowa High School,15030,1,1,0
731,2013,Corowa High School,15400,2,0,2
732,2013,Corowa High School,15140,1,0,1
733,2013,Corowa High School,15020,1,0,1
734,2013,Toronto High School,15170,2,0,2
735,2013,Toronto High School,15100,1,0,1
736,2013,Toronto High School,15060,1,0,1
737,2013,Toronto High School,15140,1,0,1
738,2013,Hunters Hill High School,15170,3,0,3
739,2013,Hunters Hill High School,15230,1,1,0
740,2013,Hunters Hill High School,15080,1,1,0
741,2013,Hunters Hill High School,15830,1,1,0
742,2013,Hunters Hill High School,15280,1,0,1
743,2013,Hunters Hill High School,15350,6,0,6
744,2013,Hunters Hill High School,15110,1,1,0
745,2013,Hunters Hill High School,15030,1,1,0
746,2013,Hunters Hill High School,15040,3,2,1
747,2013,Hunters Hill High School,15140,7,1,6
748,2013,Hunters Hill High School,15250,1,0,1
749,2013,Hunters Hill High School,15220,5,0,5
750,2013,Hunters Hill High School,15020,4,1,3
751,2013,Hillston Central School,26599,1,0,1
752,2013,Wollongong High School of the Performing Arts,15240,2,1,1
753,2013,Wollongong High School of the Performing Arts,15270,2,0,2
754,2013,Wollongong High School of the Performing Arts,15230,6,1,5
755,2013,Wollongong High School of the Performing Arts,15190,2,0,2
756,2013,Wollongong High School of the Performing Arts,15070,9,1,8
757,2013,Wollongong High School of the Performing Arts,15090,11,2,9
758,2013,Wollongong High School of the Performing Arts,15350,4,2,2
759,2013,Wollongong High School of the Performing Arts,15160,1,0,1
760,2013,Wollongong High School of the Performing Arts,15680,1,0,1
761,2013,Wollongong High School of the Performing Arts,15400,1,1,0
762,2013,Wollongong High School of the Performing Arts,15800,2,0,2
763,2013,Wollongong High School of the Performing Arts,15060,2,0,2
764,2013,Wollongong High School of the Performing Arts,15140,3,0,3
765,2013,Wollongong High School of the Performing Arts,15290,7,3,4
766,2013,Wollongong High School of the Performing Arts,15250,1,1,0
767,2013,Wollongong High School of the Performing Arts,15220,1,0,1
768,2013,Mater Dei Catholic College,15240,5,3,2
769,2013,Mater Dei Catholic College,15230,1,0,1
770,2013,Mater Dei Catholic College,15320,2,0,2
771,2013,Mater Dei Catholic College,15350,1,0,1
772,2013,Mater Dei Catholic College,26799,1,1,0
773,2013,Mater Dei Catholic College,15370,11,4,7
774,2013,Mater Dei Catholic College,26599,1,0,1
775,2013,Mater Dei Catholic College,15060,1,0,1
776,2013,Mater Dei Catholic College,15140,1,0,1
777,2013,Mater Dei Catholic College,15290,1,1,0
778,2013,Mater Dei Catholic College,15250,3,1,2
779,2013,Mater Dei Catholic College,15220,1,1,0
780,2013,Mater Dei Catholic College,15020,2,0,2
781,2013,Ravenswood School for Girls,15240,11,1,10
782,2013,Ravenswood School for Girls,15270,9,0,9
783,2013,Ravenswood School for Girls,15170,1,0,1
784,2013,Ravenswood School for Girls,15230,18,0,18
785,2013,Ravenswood School for Girls,15190,3,0,3
786,2013,Ravenswood School for Girls,15090,2,0,2
787,2013,Ravenswood School for Girls,15320,4,0,4
788,2013,Ravenswood School for Girls,15280,2,0,2
789,2013,Ravenswood School for Girls,15350,3,0,3
790,2013,Ravenswood School for Girls,15380,1,0,1
791,2013,Ravenswood School for Girls,15160,6,0,6
792,2013,Ravenswood School for Girls,15300,4,0,4
793,2013,Ravenswood School for Girls,15110,5,0,5
794,2013,Ravenswood School for Girls,15680,3,0,3
795,2013,Ravenswood School for Girls,15260,1,0,1
796,2013,Ravenswood School for Girls,15900,1,0,1
797,2013,Ravenswood School for Girls,15030,5,0,5
798,2013,Ravenswood School for Girls,15310,4,0,4
799,2013,Ravenswood School for Girls,15330,2,0,2
800,2013,Ravenswood School for Girls,15150,1,0,1
801,2013,Ravenswood School for Girls,15400,5,0,5
802,2013,Ravenswood School for Girls,15040,10,0,10
803,2013,Ravenswood School for Girls,15060,2,0,2
804,2013,Ravenswood School for Girls,15140,10,0,10
805,2013,Ravenswood School for Girls,15050,1,0,1
806,2013,Ravenswood School for Girls,15290,1,0,1
807,2013,Ravenswood School for Girls,15250,5,0,5
808,2013,Ravenswood School for Girls,15690,1,0,1
809,2013,Ravenswood School for Girls,15220,10,0,10
810,2013,Ravenswood School for Girls,15020,6,0,6
811,2013,Ravenswood School for Girls,15390,1,0,1
812,2013,Randwick Girls High School,15340,1,0,1
813,2013,Randwick Girls High School,15230,1,0,1
814,2013,Randwick Girls High School,15830,1,0,1
815,2013,Randwick Girls High School,16000,1,1,0
816,2013,Randwick Girls High School,15070,1,0,1
817,2013,Randwick Girls High School,15850,1,0,1
818,2013,Randwick Girls High School,15820,1,0,1
819,2013,Randwick Girls High School,15160,1,0,1
820,2013,Randwick Girls High School,15560,2,0,2
821,2013,Randwick Girls High School,15680,1,0,1
822,2013,Randwick Girls High School,15880,1,0,1
823,2013,Randwick Girls High School,15540,1,0,1
824,2013,Randwick Girls High School,15260,2,0,2
825,2013,Randwick Girls High School,15980,1,0,1
826,2013,Randwick Girls High School,15030,3,0,3
827,2013,Randwick Girls High School,15990,1,0,1
828,2013,Randwick Girls High School,15330,2,0,2
829,2013,Randwick Girls High School,15150,2,0,2
830,2013,Randwick Girls High School,15400,4,0,4
831,2013,Randwick Girls High School,15555,1,0,1
832,2013,Randwick Girls High School,15040,1,0,1
833,2013,Randwick Girls High School,15140,1,0,1
834,2013,Randwick Girls High School,15050,3,0,3
835,2013,Randwick Girls High School,15290,1,0,1
836,2013,Randwick Girls High School,15250,4,1,3
837,2013,Randwick Girls High School,15690,1,0,1
838,2013,Thomas Hassall Anglican College,15240,3,1,2
839,2013,Thomas Hassall Anglican College,15270,1,0,1
840,2013,Thomas Hassall Anglican College,15340,1,0,1
841,2013,Thomas Hassall Anglican College,15170,1,1,0
842,2013,Thomas Hassall Anglican College,15230,5,2,3
843,2013,Thomas Hassall Anglican College,15090,1,1,0
844,2013,Thomas Hassall Anglican College,15280,1,1,0
845,2013,Thomas Hassall Anglican College,15200,1,1,0
846,2013,Thomas Hassall Anglican College,16020,1,0,1
847,2013,Thomas Hassall Anglican College,15030,2,1,1
848,2013,Thomas Hassall Anglican College,15040,2,0,2
849,2013,Thomas Hassall Anglican College,15180,3,0,3
850,2013,Thomas Hassall Anglican College,15140,4,1,3
851,2013,Thomas Hassall Anglican College,15050,1,0,1
852,2013,Thomas Hassall Anglican College,15210,2,2,0
853,2013,Thomas Hassall Anglican College,15290,1,0,1
854,2013,Thomas Hassall Anglican College,15250,1,0,1
855,2013,Thomas Hassall Anglican College,15220,3,0,3
856,2013,Thomas Hassall Anglican College,15020,4,1,3
857,2013,Canterbury Boys High School,15240,3,3,0
858,2013,Canterbury Boys High School,15120,1,1,0
859,2013,Canterbury Boys High School,26699,1,1,0
860,2013,Canterbury Boys High School,15260,1,1,0
861,2013,Canterbury Boys High School,15030,1,1,0
862,2013,Canterbury Boys High School,15330,1,1,0
863,2013,Canterbury Boys High School,15140,1,1,0
864,2013,Canterbury Boys High School,15050,1,1,0
865,2013,Canterbury Boys High School,15210,1,1,0
866,2013,Canterbury Boys High School,15250,3,3,0
867,2013,Wyong High School,26999,1,0,1
868,2013,Wyong High School,15200,3,2,1
869,2013,Wyong High School,15060,1,0,1
870,2013,Wyong High School,15220,1,0,1
871,2013,Albury High School,15240,3,2,1
872,2013,Albury High School,15340,1,1,0
873,2013,Albury High School,15170,1,0,1
874,2013,Albury High School,15230,6,1,5
875,2013,Albury High School,15320,2,1,1
876,2013,Albury High School,15670,1,0,1
877,2013,Albury High School,15350,1,0,1
878,2013,Albury High School,15160,2,0,2
879,2013,Albury High School,15110,1,0,1
880,2013,Albury High School,15030,2,1,1
881,2013,Albury High School,15330,1,1,0
882,2013,Albury High School,15180,1,0,1
883,2013,Albury High School,15050,2,1,1
884,2013,Albury High School,15290,2,2,0
885,2013,Albury High School,15020,2,1,1
886,2013,Albury High School,15700,1,1,0
887,2013,St Clare's High School,15120,1,1,0
888,2013,St Clare's High School,15090,6,4,2
889,2013,St Clare's High School,15350,3,1,2
890,2013,St Clare's High School,15110,2,1,1
891,2013,St Clare's High School,15260,1,1,0
892,2013,St Clare's High School,15370,1,1,0
893,2013,St Clare's High School,26599,2,0,2
894,2013,St Clare's High School,15290,1,1,0
895,2013,St Clare's High School,15250,2,2,0
896,2013,St Clare's High School,15220,1,1,0
897,2013,St Clare's High School,15390,1,0,1
898,2013,Orange High School,15240,5,3,2
899,2013,Orange High School,15170,1,1,0
900,2013,Orange High School,15230,1,1,0
901,2013,Orange High School,27199,1,0,1
902,2013,Orange High School,15070,1,0,1
903,2013,Orange High School,15320,2,1,1
904,2013,Orange High School,15350,1,0,1
905,2013,Orange High School,15300,2,0,2
906,2013,Orange High School,15030,3,2,1
907,2013,Orange High School,26599,1,0,1
908,2013,Orange High School,15330,1,1,0
909,2013,Orange High School,15060,2,0,2
910,2013,Orange High School,15140,1,0,1
911,2013,Orange High School,15050,3,1,2
912,2013,Orange High School,15290,2,1,1
913,2013,Orange High School,15250,3,1,2
914,2013,Orange High School,15700,1,0,1
915,2013,Caringbah High School,15240,22,6,16
916,2013,Caringbah High School,15270,6,4,2
917,2013,Caringbah High School,15230,2,1,1
918,2013,Caringbah High School,15830,1,0,1
919,2013,Caringbah High School,15120,3,3,0
920,2013,Caringbah High School,15070,1,1,0
921,2013,Caringbah High School,15850,1,0,1
922,2013,Caringbah High School,15320,2,0,2
923,2013,Caringbah High School,15280,1,0,1
924,2013,Caringbah High School,15350,6,1,5
925,2013,Caringbah High School,15160,6,2,4
926,2013,Caringbah High School,15110,3,1,2
927,2013,Caringbah High School,15710,3,2,1
928,2013,Caringbah High School,15680,4,1,3
929,2013,Caringbah High School,15260,4,3,1
930,2013,Caringbah High School,15030,5,1,4
931,2013,Caringbah High School,15370,3,0,3
932,2013,Caringbah High School,15310,4,1,3
933,2013,Caringbah High School,15330,6,4,2
934,2013,Caringbah High School,15400,3,0,3
935,2013,Caringbah High School,15040,10,6,4
936,2013,Caringbah High School,15140,12,1,11
937,2013,Caringbah High School,15050,10,4,6
938,2013,Caringbah High School,15210,3,2,1
939,2013,Caringbah High School,15250,17,7,10
940,2013,Caringbah High School,15220,16,3,13
941,2013,Caringbah High School,15020,5,3,2
942,2013,East Hills Boys High School,15240,1,1,0
943,2013,East Hills Boys High School,15230,4,4,0
944,2013,East Hills Boys High School,15120,2,2,0
945,2013,East Hills Boys High School,15200,1,1,0
946,2013,East Hills Boys High School,15330,1,1,0
947,2013,East Hills Boys High School,15250,2,1,1
948,2013,SCECGS Redlands,15240,1,1,0
949,2013,SCECGS Redlands,15270,3,1,2
950,2013,SCECGS Redlands,15340,3,2,1
951,2013,SCECGS Redlands,15170,4,3,1
952,2013,SCECGS Redlands,15230,6,4,2
953,2013,SCECGS Redlands,15190,2,1,1
954,2013,SCECGS Redlands,16000,1,0,1
955,2013,SCECGS Redlands,15090,4,2,2
956,2013,SCECGS Redlands,15550,2,1,1
957,2013,SCECGS Redlands,15320,1,0,1
958,2013,SCECGS Redlands,15160,3,2,1
959,2013,SCECGS Redlands,15300,3,3,0
960,2013,SCECGS Redlands,15110,1,1,0
961,2013,SCECGS Redlands,15570,2,1,1
962,2013,SCECGS Redlands,15030,1,1,0
963,2013,SCECGS Redlands,15310,3,3,0
964,2013,SCECGS Redlands,15400,5,2,3
965,2013,SCECGS Redlands,15040,3,1,2
966,2013,SCECGS Redlands,15140,3,2,1
967,2013,SCECGS Redlands,15050,1,1,0
968,2013,SCECGS Redlands,15210,1,1,0
969,2013,SCECGS Redlands,15020,2,1,1
970,2013,SCECGS Redlands,15390,1,1,0
971,2013,Katoomba High School,15330,1,1,0
972,2013,Katoomba High School,15050,1,1,0
973,2013,Katoomba High School,15250,1,1,0
974,2013,Katoomba High School,15390,1,0,1
975,2013,Mount View High School,15230,1,0,1
976,2013,Mount View High School,15200,1,0,1
977,2013,Mount View High School,15060,1,0,1
978,2013,Epping Boys High School,15240,11,9,2
979,2013,Epping Boys High School,15270,2,2,0
980,2013,Epping Boys High School,15170,2,2,0
981,2013,Epping Boys High School,15230,10,10,0
982,2013,Epping Boys High School,15080,1,1,0
983,2013,Epping Boys High School,15120,4,4,0
984,2013,Epping Boys High School,15360,2,2,0
985,2013,Epping Boys High School,15090,1,1,0
986,2013,Epping Boys High School,15320,2,2,0
987,2013,Epping Boys High School,15280,1,1,0
988,2013,Epping Boys High School,15200,2,2,0
989,2013,Epping Boys High School,15820,1,1,0
990,2013,Epping Boys High School,15160,1,1,0
991,2013,Epping Boys High School,15300,1,1,0
992,2013,Epping Boys High School,15110,7,7,0
993,2013,Epping Boys High School,15260,10,10,0
994,2013,Epping Boys High School,15030,3,3,0
995,2013,Epping Boys High School,15790,1,1,0
996,2013,Epping Boys High School,15310,1,1,0
997,2013,Epping Boys High School,26599,1,1,0
998,2013,Epping Boys High School,15330,12,12,0
999,2013,Epping Boys High School,15400,5,5,0
1000,2013,Epping Boys High School,15040,4,3,1
1001,2013,Epping Boys High School,15885,1,1,0
1002,2013,Epping Boys High School,15140,5,5,0
1003,2013,Epping Boys High School,15130,4,4,0
1004,2013,Epping Boys High School,15050,8,8,0
1005,2013,Epping Boys High School,15210,2,2,0
1006,2013,Epping Boys High School,15290,1,1,0
1007,2013,Epping Boys High School,15250,19,19,0
1008,2013,Epping Boys High School,15220,2,2,0
1009,2013,Epping Boys High School,15020,3,3,0
1010,2013,Aquinas Catholic College,15240,10,1,9
1011,2013,Aquinas Catholic College,26999,1,0,1
1012,2013,Aquinas Catholic College,15230,3,1,2
1013,2013,Aquinas Catholic College,15190,3,0,3
1014,2013,Aquinas Catholic College,15080,3,0,3
1015,2013,Aquinas Catholic College,15320,4,1,3
1016,2013,Aquinas Catholic College,15280,1,0,1
1017,2013,Aquinas Catholic College,15200,1,1,0
1018,2013,Aquinas Catholic College,15380,1,0,1
1019,2013,Aquinas Catholic College,15110,1,0,1
1020,2013,Aquinas Catholic College,15030,1,0,1
1021,2013,Aquinas Catholic College,15370,9,1,8
1022,2013,Aquinas Catholic College,26599,1,0,1
1023,2013,Aquinas Catholic College,15400,4,0,4
1024,2013,Aquinas Catholic College,15040,4,1,3
1025,2013,Aquinas Catholic College,15060,3,0,3
1026,2013,Aquinas Catholic College,15290,2,2,0
1027,2013,Aquinas Catholic College,15250,2,0,2
1028,2013,Aquinas Catholic College,15220,5,0,5
1029,2013,Aquinas Catholic College,15020,5,0,5
1030,2013,Armidale High School,15090,9,5,4
1031,2013,Armidale High School,15350,1,0,1
1032,2013,Armidale High School,15260,1,1,0
1033,2013,Armidale High School,15030,1,1,0
1034,2013,Armidale High School,15310,3,2,1
1035,2013,Armidale High School,26599,1,1,0
1036,2013,Armidale High School,15330,2,2,0
1037,2013,Armidale High School,15400,2,0,2
1038,2013,Armidale High School,15050,2,2,0
1039,2013,Armidale High School,15290,1,1,0
1040,2013,Armidale High School,15250,3,2,1
1041,2013,Rouse Hill Anglican College,15240,4,3,1
1042,2013,Rouse Hill Anglican College,15170,1,0,1
1043,2013,Rouse Hill Anglican College,15230,2,2,0
1044,2013,Rouse Hill Anglican College,16080,1,0,1
1045,2013,Rouse Hill Anglican College,15200,1,1,0
1046,2013,Rouse Hill Anglican College,15030,1,0,1
1047,2013,Rouse Hill Anglican College,15040,1,1,0
1048,2013,Rouse Hill Anglican College,15060,2,0,2
1049,2013,Rouse Hill Anglican College,15050,2,1,1
1050,2013,Rouse Hill Anglican College,15250,3,1,2
1051,2013,Strathfield Girls High School,15240,11,0,11
1052,2013,Strathfield Girls High School,15270,1,0,1
1053,2013,Strathfield Girls High School,15340,5,0,5
1054,2013,Strathfield Girls High School,15170,1,0,1
1055,2013,Strathfield Girls High School,15230,2,0,2
1056,2013,Strathfield Girls High School,15830,3,1,2
1057,2013,Strathfield Girls High School,15850,2,0,2
1058,2013,Strathfield Girls High School,15320,2,0,2
1059,2013,Strathfield Girls High School,15350,3,0,3
1060,2013,Strathfield Girls High School,15820,4,0,4
1061,2013,Strathfield Girls High School,15300,1,0,1
1062,2013,Strathfield Girls High School,15110,2,0,2
1063,2013,Strathfield Girls High School,16020,1,0,1
1064,2013,Strathfield Girls High School,15260,2,0,2
1065,2013,Strathfield Girls High School,15030,6,0,6
1066,2013,Strathfield Girls High School,15370,2,0,2
1067,2013,Strathfield Girls High School,15310,3,1,2
1068,2013,Strathfield Girls High School,26599,3,0,3
1069,2013,Strathfield Girls High School,15330,2,0,2
1070,2013,Strathfield Girls High School,15150,1,0,1
1071,2013,Strathfield Girls High School,15400,1,0,1
1072,2013,Strathfield Girls High School,15555,1,0,1
1073,2013,Strathfield Girls High School,15040,2,0,2
1074,2013,Strathfield Girls High School,15885,2,0,2
1075,2013,Strathfield Girls High School,15180,4,0,4
1076,2013,Strathfield Girls High School,15060,4,0,4
1077,2013,Strathfield Girls High School,15140,5,0,5
1078,2013,Strathfield Girls High School,15130,2,0,2
1079,2013,Strathfield Girls High School,15050,6,0,6
1080,2013,Strathfield Girls High School,15210,2,0,2
1081,2013,Strathfield Girls High School,15290,1,0,1
1082,2013,Strathfield Girls High School,15250,5,0,5
1083,2013,Strathfield Girls High School,15220,2,0,2
1084,2013,Redeemer Baptist School,16080,1,0,1
1085,2013,St Edward's Christian Brothers' College,15240,1,1,0
1086,2013,St Edward's Christian Brothers' College,15340,2,2,0
1087,2013,St Edward's Christian Brothers' College,15230,4,4,0
1088,2013,St Edward's Christian Brothers' College,15090,1,1,0
1089,2013,St Edward's Christian Brothers' College,15320,4,4,0
1090,2013,St Edward's Christian Brothers' College,15670,1,1,0
1091,2013,St Edward's Christian Brothers' College,15200,7,7,0
1092,2013,St Edward's Christian Brothers' College,15160,2,2,0
1093,2013,St Edward's Christian Brothers' College,15110,1,1,0
1094,2013,St Edward's Christian Brothers' College,15370,4,4,0
1095,2013,St Edward's Christian Brothers' College,15330,1,1,0
1096,2013,St Edward's Christian Brothers' College,15400,2,2,0
1097,2013,St Edward's Christian Brothers' College,15040,4,4,0
1098,2013,St Edward's Christian Brothers' College,15180,1,1,0
1099,2013,St Edward's Christian Brothers' College,26099,1,1,0
1100,2013,St Edward's Christian Brothers' College,15140,1,1,0
1101,2013,St Edward's Christian Brothers' College,15050,1,1,0
1102,2013,St Edward's Christian Brothers' College,15210,2,2,0
1103,2013,St Edward's Christian Brothers' College,15290,2,2,0
1104,2013,St Edward's Christian Brothers' College,15250,1,1,0
1105,2013,St Edward's Christian Brothers' College,15220,4,4,0
1106,2013,Sir Joseph Banks High School,15240,1,1,0
1107,2013,Prairiewood High School,15240,2,1,1
1108,2013,Prairiewood High School,26499,1,0,1
1109,2013,Prairiewood High School,15170,1,0,1
1110,2013,Prairiewood High School,15160,2,0,2
1111,2013,Prairiewood High School,15060,1,0,1
1112,2013,Prairiewood High School,15140,1,0,1
1113,2013,Prairiewood High School,15290,1,0,1
1114,2013,Prairiewood High School,15250,1,1,0
1115,2013,St Francis De Sales Regional College,15340,1,0,1
1116,2013,St Francis De Sales Regional College,15230,2,1,1
1117,2013,St Francis De Sales Regional College,15320,2,1,1
1118,2013,St Francis De Sales Regional College,15200,2,2,0
1119,2013,St Francis De Sales Regional College,15030,1,1,0
1120,2013,St Francis De Sales Regional College,26599,2,1,1
1121,2013,St Francis De Sales Regional College,15400,2,1,1
1122,2013,St Francis De Sales Regional College,15140,1,1,0
1123,2013,St Francis De Sales Regional College,15290,3,1,2
1124,2013,St Francis De Sales Regional College,15390,1,0,1
1125,2013,Trinity Catholic College Lismore,15240,4,3,1
1126,2013,Trinity Catholic College Lismore,15170,2,0,2
1127,2013,Trinity Catholic College Lismore,15230,1,0,1
1128,2013,Trinity Catholic College Lismore,15070,3,0,3
1129,2013,Trinity Catholic College Lismore,15090,5,2,3
1130,2013,Trinity Catholic College Lismore,15670,2,0,2
1131,2013,Trinity Catholic College Lismore,15350,1,0,1
1132,2013,Trinity Catholic College Lismore,15380,7,1,6
1133,2013,Trinity Catholic College Lismore,15160,1,0,1
1134,2013,Trinity Catholic College Lismore,15680,1,0,1
1135,2013,Trinity Catholic College Lismore,15030,4,1,3
1136,2013,Trinity Catholic College Lismore,15370,8,3,5
1137,2013,Trinity Catholic College Lismore,15810,2,0,2
1138,2013,Trinity Catholic College Lismore,15400,4,0,4
1139,2013,Trinity Catholic College Lismore,15800,3,0,3
1140,2013,Trinity Catholic College Lismore,15060,3,0,3
1141,2013,Trinity Catholic College Lismore,15140,6,1,5
1142,2013,Trinity Catholic College Lismore,15210,1,1,0
1143,2013,Trinity Catholic College Lismore,15020,2,1,1
1144,2013,Erskine Park High School,15230,3,1,2
1145,2013,Erskine Park High School,15350,1,0,1
1146,2013,Erskine Park High School,15040,1,1,0
1147,2013,Erskine Park High School,15060,1,0,1
1148,2013,Erskine Park High School,15130,1,1,0
1149,2013,Erskine Park High School,15250,1,1,0
1150,2013,Erskine Park High School,15220,3,0,3
1151,2013,Coonamble High School,15060,1,0,1
1152,2013,Coonamble High School,26099,1,1,0
1153,2013,Mulwaree High School,15240,1,1,0
1154,2013,Mulwaree High School,15270,1,0,1
1155,2013,Mulwaree High School,15550,1,0,1
1156,2013,Mulwaree High School,15320,1,0,1
1157,2013,Mulwaree High School,15670,1,1,0
1158,2013,Mulwaree High School,15200,2,2,0
1159,2013,Mulwaree High School,15030,2,0,2
1160,2013,Mulwaree High School,15060,2,0,2
1161,2013,Mulwaree High School,15210,1,1,0
1162,2013,Mulwaree High School,15020,1,0,1
1163,2013,Lightning Ridge Central School,15200,1,1,0
1164,2013,Bowral High School,15340,2,2,0
1165,2013,Bowral High School,15230,3,0,3
1166,2013,Bowral High School,15120,1,1,0
1167,2013,Bowral High School,15320,2,1,1
1168,2013,Bowral High School,15030,3,0,3
1169,2013,Bowral High School,15400,4,1,3
1170,2013,Bowral High School,15100,1,0,1
1171,2013,Bowral High School,15290,3,1,2
1172,2013,Bethlehem College,15270,6,0,6
1173,2013,Bethlehem College,15170,1,0,1
1174,2013,Bethlehem College,15230,3,0,3
1175,2013,Bethlehem College,15280,4,0,4
1176,2013,Bethlehem College,15350,3,0,3
1177,2013,Bethlehem College,15160,2,0,2
1178,2013,Bethlehem College,16020,1,0,1
1179,2013,Bethlehem College,15260,1,0,1
1180,2013,Bethlehem College,15030,3,0,3
1181,2013,Bethlehem College,15370,19,0,19
1182,2013,Bethlehem College,26599,2,0,2
1183,2013,Bethlehem College,15330,1,0,1
1184,2013,Bethlehem College,15040,2,0,2
1185,2013,Bethlehem College,15800,1,0,1
1186,2013,Bethlehem College,15140,6,0,6
1187,2013,Bethlehem College,15050,2,0,2
1188,2013,Bethlehem College,15210,4,0,4
1189,2013,Bethlehem College,15290,1,0,1
1190,2013,Bethlehem College,15250,2,0,2
1191,2013,Bethlehem College,15220,3,0,3
1192,2013,Scone Grammar School,15720,1,1,0
1193,2013,Scone Grammar School,15090,3,1,2
1194,2013,Scone Grammar School,15280,1,0,1
1195,2013,Scone Grammar School,15710,1,1,0
1196,2013,Scone Grammar School,15310,1,0,1
1197,2013,Scone Grammar School,15020,2,0,2
1198,2013,Mount Annan Christian College,15320,1,1,0
1199,2013,Mount Annan Christian College,15350,1,0,1
1200,2013,Mount Annan Christian College,15160,1,0,1
1201,2013,Mount Annan Christian College,15290,2,2,0
1202,2013,Singleton High School,15270,1,0,1
1203,2013,Singleton High School,15080,2,2,0
1204,2013,Singleton High School,15320,1,0,1
1205,2013,Singleton High School,15200,3,3,0
1206,2013,Singleton High School,15160,1,0,1
1207,2013,Singleton High School,15030,1,0,1
1208,2013,Singleton High School,15100,1,0,1
1209,2013,Singleton High School,15220,1,0,1
1210,2013,Kotara High School,15240,3,1,2
1211,2013,Kotara High School,15340,1,1,0
1212,2013,Kotara High School,15170,1,0,1
1213,2013,Kotara High School,15230,4,2,2
1214,2013,Kotara High School,15320,2,1,1
1215,2013,Kotara High School,15350,1,0,1
1216,2013,Kotara High School,15200,2,2,0
1217,2013,Kotara High School,15160,1,0,1
1218,2013,Kotara High School,15680,1,0,1
1219,2013,Kotara High School,15000,1,0,1
1220,2013,Kotara High School,15030,3,1,2
1221,2013,Kotara High School,15330,1,0,1
1222,2013,Kotara High School,15400,1,0,1
1223,2013,Kotara High School,15060,1,0,1
1224,2013,Kotara High School,15050,1,1,0
1225,2013,Kotara High School,15290,2,2,0
1226,2013,Bonnyrigg High School,15270,2,2,0
1227,2013,Bonnyrigg High School,15170,2,2,0
1228,2013,Bonnyrigg High School,15190,1,0,1
1229,2013,Bonnyrigg High School,15320,1,1,0
1230,2013,Bonnyrigg High School,15280,1,1,0
1231,2013,Bonnyrigg High School,15160,1,1,0
1232,2013,Bonnyrigg High School,15110,1,1,0
1233,2013,Bonnyrigg High School,15260,2,2,0
1234,2013,Bonnyrigg High School,15330,1,1,0
1235,2013,Bonnyrigg High School,15040,3,2,1
1236,2013,Bonnyrigg High School,15140,3,2,1
1237,2013,Bonnyrigg High School,15050,2,2,0
1238,2013,Bonnyrigg High School,15290,1,0,1
1239,2013,Bonnyrigg High School,15250,3,3,0
1240,2013,Bonnyrigg High School,15020,1,1,0
1241,2013,Bonnyrigg High School,15390,1,0,1
1242,2013,Bethany College,15270,6,0,6
1243,2013,Bethany College,15170,3,0,3
1244,2013,Bethany College,15230,3,0,3
1245,2013,Bethany College,15090,1,0,1
1246,2013,Bethany College,15320,1,0,1
1247,2013,Bethany College,15350,5,0,5
1248,2013,Bethany College,15380,5,0,5
1249,2013,Bethany College,15030,1,1,0
1250,2013,Bethany College,15370,9,0,9
1251,2013,Bethany College,15400,2,0,2
1252,2013,Bethany College,15040,1,0,1
1253,2013,Bethany College,15060,1,0,1
1254,2013,Bethany College,15140,2,0,2
1255,2013,Bethany College,15220,2,0,2
1256,2013,Bethany College,15020,1,0,1
1257,2013,Bethany College,15390,1,0,1
1258,2013,Domremy Catholic College,15240,6,0,6
1259,2013,Domremy Catholic College,15270,2,0,2
1260,2013,Domremy Catholic College,15170,1,0,1
1261,2013,Domremy Catholic College,15230,3,0,3
1262,2013,Domremy Catholic College,15190,1,0,1
1263,2013,Domremy Catholic College,15320,1,0,1
1264,2013,Domremy Catholic College,15350,3,0,3
1265,2013,Domremy Catholic College,15380,5,0,5
1266,2013,Domremy Catholic College,15160,4,0,4
1267,2013,Domremy Catholic College,15110,2,0,2
1268,2013,Domremy Catholic College,15030,5,0,5
1269,2013,Domremy Catholic College,15370,3,0,3
1270,2013,Domremy Catholic College,15040,3,0,3
1271,2013,Domremy Catholic College,15800,2,0,2
1272,2013,Domremy Catholic College,15180,2,0,2
1273,2013,Domremy Catholic College,15060,5,0,5
1274,2013,Domremy Catholic College,15140,16,0,16
1275,2013,Domremy Catholic College,15050,1,0,1
1276,2013,Domremy Catholic College,15210,3,0,3
1277,2013,Domremy Catholic College,15290,2,0,2
1278,2013,Domremy Catholic College,15250,2,0,2
1279,2013,Domremy Catholic College,15220,4,0,4
1280,2013,Domremy Catholic College,15020,1,0,1
1281,2013,Domremy Catholic College,15390,3,0,3
1282,2013,Irrawang High School,15340,1,1,0
1283,2013,Irrawang High School,15290,1,0,1
1284,2013,Nagle College,15230,2,0,2
1285,2013,Nagle College,15320,1,0,1
1286,2013,Nagle College,15350,1,0,1
1287,2013,Nagle College,15160,1,0,1
1288,2013,Nagle College,15030,1,0,1
1289,2013,Nagle College,15370,9,0,9
1290,2013,Nagle College,26599,2,0,2
1291,2013,Nagle College,15040,2,0,2
1292,2013,Nagle College,15060,4,1,3
1293,2013,Nagle College,15290,2,1,1
1294,2013,Nagle College,15220,4,0,4
1295,2013,Kambala,15240,11,0,11
1296,2013,Kambala,15270,8,0,8
1297,2013,Kambala,15170,5,0,5
1298,2013,Kambala,15230,6,1,5
1299,2013,Kambala,15190,3,0,3
1300,2013,Kambala,15080,5,0,5
1301,2013,Kambala,15090,2,0,2
1302,2013,Kambala,15320,4,0,4
1303,2013,Kambala,15280,9,0,9
1304,2013,Kambala,15160,8,0,8
1305,2013,Kambala,15300,9,0,9
1306,2013,Kambala,15110,8,0,8
1307,2013,Kambala,15910,1,0,1
1308,2013,Kambala,15680,5,0,5
1309,2013,Kambala,15900,2,0,2
1310,2013,Kambala,15030,3,0,3
1311,2013,Kambala,15370,1,0,1
1312,2013,Kambala,15310,7,0,7
1313,2013,Kambala,26599,1,0,1
1314,2013,Kambala,15970,2,0,2
1315,2013,Kambala,15400,15,0,15
1316,2013,Kambala,15555,1,0,1
1317,2013,Kambala,15040,12,1,11
1318,2013,Kambala,15140,39,0,39
1319,2013,Kambala,15130,1,0,1
1320,2013,Kambala,15050,3,0,3
1321,2013,Kambala,15210,5,1,4
1322,2013,Kambala,15250,5,0,5
1323,2013,Kambala,15690,1,0,1
1324,2013,Kambala,15220,4,0,4
1325,2013,Kambala,15020,13,0,13
1326,2013,Bankstown Senior College,15560,2,0,2
1327,2013,Bankstown Senior College,16010,3,1,2
1328,2013,Woonona High School,15320,1,0,1
1329,2013,Woonona High School,15350,1,0,1
1330,2013,Woonona High School,26599,1,0,1
1331,2013,Woonona High School,15400,2,1,1
1332,2013,Woonona High School,15040,3,0,3
1333,2013,Woonona High School,15140,1,1,0
1334,2013,Woonona High School,15210,4,1,3
1335,2013,Woonona High School,15290,1,1,0
1336,2013,Brigidine College Randwick,15240,8,0,8
1337,2013,Brigidine College Randwick,15270,5,0,5
1338,2013,Brigidine College Randwick,15230,5,1,4
1339,2013,Brigidine College Randwick,15080,2,0,2
1340,2013,Brigidine College Randwick,15090,2,0,2
1341,2013,Brigidine College Randwick,15320,4,0,4
1342,2013,Brigidine College Randwick,15280,1,0,1
1343,2013,Brigidine College Randwick,15380,4,0,4
1344,2013,Brigidine College Randwick,15160,2,0,2
1345,2013,Brigidine College Randwick,15030,3,0,3
1346,2013,Brigidine College Randwick,15370,4,0,4
1347,2013,Brigidine College Randwick,26599,5,1,4
1348,2013,Brigidine College Randwick,15970,2,0,2
1349,2013,Brigidine College Randwick,15400,4,0,4
1350,2013,Brigidine College Randwick,15040,2,0,2
1351,2013,Brigidine College Randwick,15180,4,1,3
1352,2013,Brigidine College Randwick,15060,3,0,3
1353,2013,Brigidine College Randwick,15140,7,0,7
1354,2013,Brigidine College Randwick,15130,1,0,1
1355,2013,Brigidine College Randwick,15050,4,0,4
1356,2013,Brigidine College Randwick,15290,2,0,2
1357,2013,Brigidine College Randwick,15250,5,0,5
1358,2013,Brigidine College Randwick,15220,2,0,2
1359,2013,Brigidine College Randwick,15020,1,0,1
1360,2013,Kandos High School,15020,1,0,1
1361,2013,Leumeah High School,15190,2,0,2
1362,2013,Leumeah High School,15820,1,0,1
1363,2013,Leumeah High School,15060,1,0,1
1364,2013,Leumeah High School,15290,1,0,1
1365,2013,Leumeah High School,15220,1,1,0
1366,2013,Dulwich High School of Visual Arts and Design,15350,1,1,0
1367,2013,Dulwich High School of Visual Arts and Design,15400,2,1,1
1368,2013,Dulwich High School of Visual Arts and Design,15800,1,0,1
1369,2013,Dulwich High School of Visual Arts and Design,15390,1,0,1
1370,2013,Hawkesbury High School,15020,1,1,0
1371,2013,The Riverina Anglican College,15240,3,2,1
1372,2013,The Riverina Anglican College,15340,2,1,1
1373,2013,The Riverina Anglican College,15360,2,2,0
1374,2013,The Riverina Anglican College,15200,1,1,0
1375,2013,The Riverina Anglican College,26799,1,1,0
1376,2013,The Riverina Anglican College,15030,3,0,3
1377,2013,The Riverina Anglican College,15400,2,0,2
1378,2013,The Riverina Anglican College,15040,1,0,1
1379,2013,The Riverina Anglican College,15140,1,0,1
1380,2013,The Riverina Anglican College,15250,2,1,1
1381,2013,The Riverina Anglican College,15390,1,0,1
1382,2013,Wollumbin High School,15340,1,0,1
1383,2013,Wollumbin High School,15060,1,0,1
1384,2013,Brigidine College St Ives,15240,2,0,2
1385,2013,Brigidine College St Ives,15270,3,0,3
1386,2013,Brigidine College St Ives,15170,2,0,2
1387,2013,Brigidine College St Ives,15230,4,0,4
1388,2013,Brigidine College St Ives,16080,1,0,1
1389,2013,Brigidine College St Ives,15090,4,0,4
1390,2013,Brigidine College St Ives,15280,2,0,2
1391,2013,Brigidine College St Ives,15350,3,0,3
1392,2013,Brigidine College St Ives,15380,4,0,4
1393,2013,Brigidine College St Ives,15160,4,0,4
1394,2013,Brigidine College St Ives,15680,2,0,2
1395,2013,Brigidine College St Ives,15030,2,0,2
1396,2013,Brigidine College St Ives,15370,4,0,4
1397,2013,Brigidine College St Ives,15310,1,0,1
1398,2013,Brigidine College St Ives,15400,5,1,4
1399,2013,Brigidine College St Ives,15040,5,0,5
1400,2013,Brigidine College St Ives,15180,1,0,1
1401,2013,Brigidine College St Ives,15140,10,0,10
1402,2013,Brigidine College St Ives,15290,4,0,4
1403,2013,Brigidine College St Ives,15220,2,0,2
1404,2013,Brigidine College St Ives,15020,3,0,3
1405,2013,Brigidine College St Ives,15390,6,0,6
1406,2013,Brigidine College St Ives,15700,1,0,1
1407,2013,Edmund Rice College,15340,2,2,0
1408,2013,Edmund Rice College,15200,7,7,0
1409,2013,Edmund Rice College,26799,1,1,0
1410,2013,Edmund Rice College,15160,2,2,0
1411,2013,Edmund Rice College,15260,1,1,0
1412,2013,Edmund Rice College,15030,6,6,0
1413,2013,Edmund Rice College,15370,4,4,0
1414,2013,Edmund Rice College,15330,1,1,0
1415,2013,Edmund Rice College,15400,1,1,0
1416,2013,Edmund Rice College,15050,4,4,0
1417,2013,Edmund Rice College,15250,2,2,0
1418,2013,Edmund Rice College,15020,2,2,0
1419,2013,Mosman High School,15240,1,1,0
1420,2013,Mosman High School,15270,2,1,1
1421,2013,Mosman High School,15340,4,2,2
1422,2013,Mosman High School,15170,3,1,2
1423,2013,Mosman High School,15230,1,1,0
1424,2013,Mosman High School,15080,4,0,4
1425,2013,Mosman High School,15090,5,0,5
1426,2013,Mosman High School,15320,1,0,1
1427,2013,Mosman High School,15280,1,1,0
1428,2013,Mosman High School,16070,1,0,1
1429,2013,Mosman High School,15160,7,3,4
1430,2013,Mosman High School,15260,1,0,1
1431,2013,Mosman High School,15030,5,2,3
1432,2013,Mosman High School,15330,2,2,0
1433,2013,Mosman High School,15400,6,0,6
1434,2013,Mosman High School,15100,1,1,0
1435,2013,Mosman High School,15140,14,5,9
1436,2013,Mosman High School,15050,1,1,0
1437,2013,Mosman High School,15290,2,0,2
1438,2013,Mosman High School,15250,2,1,1
1439,2013,Mosman High School,15220,1,1,0
1440,2013,Mosman High School,15020,1,1,0
1441,2013,Mosman High School,15390,1,0,1
1442,2013,St Spyridon College,15270,3,3,0
1443,2013,St Spyridon College,15170,1,1,0
1444,2013,St Spyridon College,15230,3,3,0
1445,2013,St Spyridon College,15320,1,1,0
1446,2013,St Spyridon College,15280,2,2,0
1447,2013,St Spyridon College,15160,3,3,0
1448,2013,St Spyridon College,15110,2,2,0
1449,2013,St Spyridon College,26699,1,1,0
1450,2013,St Spyridon College,15980,2,0,2
1451,2013,St Spyridon College,26599,3,0,3
1452,2013,St Spyridon College,15990,1,0,1
1453,2013,St Spyridon College,15040,2,2,0
1454,2013,St Spyridon College,15180,2,0,2
1455,2013,St Spyridon College,15140,2,2,0
1456,2013,St Spyridon College,15210,1,1,0
1457,2013,St Spyridon College,15220,4,3,1
1458,2013,St Spyridon College,15020,1,1,0
1459,2013,Lake Illawarra High School,15400,1,0,1
1460,2013,Lake Illawarra High School,15060,1,0,1
1461,2013,Green Valley Islamic College,15230,4,1,3
1462,2013,Green Valley Islamic College,15380,2,0,2
1463,2013,Green Valley Islamic College,15040,1,0,1
1464,2013,Green Valley Islamic College,15140,1,0,1
1465,2013,Mullumbimby High School,15240,1,1,0
1466,2013,Mullumbimby High School,15340,1,0,1
1467,2013,Mullumbimby High School,15170,3,1,2
1468,2013,Mullumbimby High School,15030,1,1,0
1469,2013,Mullumbimby High School,15140,1,0,1
1470,2013,Mullumbimby High School,15250,1,1,0
1471,2013,Mullumbimby High School,15700,1,1,0
1472,2013,Shoalhaven Anglican School,15160,1,0,1
1473,2013,Marcellin College,15240,14,14,0
1474,2013,Marcellin College,15270,2,2,0
1475,2013,Marcellin College,15170,4,4,0
1476,2013,Marcellin College,15230,4,4,0
1477,2013,Marcellin College,15190,1,1,0
1478,2013,Marcellin College,15080,1,1,0
1479,2013,Marcellin College,15360,1,1,0
1480,2013,Marcellin College,15320,4,4,0
1481,2013,Marcellin College,15280,2,2,0
1482,2013,Marcellin College,15200,1,1,0
1483,2013,Marcellin College,15160,1,1,0
1484,2013,Marcellin College,15110,1,1,0
1485,2013,Marcellin College,16020,1,1,0
1486,2013,Marcellin College,15260,1,1,0
1487,2013,Marcellin College,15370,13,13,0
1488,2013,Marcellin College,15330,1,1,0
1489,2013,Marcellin College,15040,4,4,0
1490,2013,Marcellin College,15140,1,1,0
1491,2013,Marcellin College,15050,1,1,0
1492,2013,Marcellin College,15210,4,4,0
1493,2013,Marcellin College,15290,4,4,0
1494,2013,Marcellin College,15250,5,5,0
1495,2013,Marcellin College,15220,4,4,0
1496,2013,Marcellin College,15020,2,2,0
1497,2013,Cowra High School,15230,2,1,1
1498,2013,Cowra High School,15090,1,1,0
1499,2013,Cowra High School,15320,1,0,1
1500,2013,Cowra High School,15060,2,0,2
1501,2013,Hoxton Park High School,15040,1,1,0
1502,2013,Knox Grammar School,15240,36,34,2
1503,2013,Knox Grammar School,15270,21,21,0
1504,2013,Knox Grammar School,15170,4,4,0
1505,2013,Knox Grammar School,15230,45,45,0
1506,2013,Knox Grammar School,15190,1,1,0
1507,2013,Knox Grammar School,15080,5,5,0
1508,2013,Knox Grammar School,15830,1,1,0
1509,2013,Knox Grammar School,15360,3,3,0
1510,2013,Knox Grammar School,15090,6,6,0
1511,2013,Knox Grammar School,15850,1,1,0
1512,2013,Knox Grammar School,15320,3,3,0
1513,2013,Knox Grammar School,15280,5,5,0
1514,2013,Knox Grammar School,15350,2,2,0
1515,2013,Knox Grammar School,15200,4,4,0
1516,2013,Knox Grammar School,15160,7,7,0
1517,2013,Knox Grammar School,15300,6,6,0
1518,2013,Knox Grammar School,15110,16,16,0
1519,2013,Knox Grammar School,15710,1,1,0
1520,2013,Knox Grammar School,15260,9,9,0
1521,2013,Knox Grammar School,15030,4,4,0
1522,2013,Knox Grammar School,15310,3,3,0
1523,2013,Knox Grammar School,15330,7,7,0
1524,2013,Knox Grammar School,15400,11,11,0
1525,2013,Knox Grammar School,15100,3,3,0
1526,2013,Knox Grammar School,15040,20,20,0
1527,2013,Knox Grammar School,15140,31,31,0
1528,2013,Knox Grammar School,15050,16,16,0
1529,2013,Knox Grammar School,15210,3,3,0
1530,2013,Knox Grammar School,15290,4,4,0
1531,2013,Knox Grammar School,15250,30,30,0
1532,2013,Knox Grammar School,15220,11,11,0
1533,2013,Knox Grammar School,15020,3,3,0
1534,2013,Knox Grammar School,15010,2,2,0
1535,2013,Riverina Institute - Wagga Wagga Campus,15220,1,0,1
1536,2013,"Illawarra Christian School, Cordeaux Campus",15240,3,2,1
1537,2013,"Illawarra Christian School, Cordeaux Campus",15270,1,0,1
1538,2013,"Illawarra Christian School, Cordeaux Campus",15170,1,0,1
1539,2013,"Illawarra Christian School, Cordeaux Campus",15090,1,0,1
1540,2013,"Illawarra Christian School, Cordeaux Campus",15200,1,1,0
1541,2013,"Illawarra Christian School, Cordeaux Campus",15160,2,0,2
1542,2013,"Illawarra Christian School, Cordeaux Campus",15040,2,2,0
1543,2013,"Illawarra Christian School, Cordeaux Campus",15140,3,0,3
1544,2013,Merrylands High School,15240,4,3,1
1545,2013,Merrylands High School,15230,2,1,1
1546,2013,Merrylands High School,15330,1,1,0
1547,2013,Merrylands High School,15250,1,1,0
1548,2013,Lisarow High School,15240,1,1,0
1549,2013,Lisarow High School,15340,3,2,1
1550,2013,Lisarow High School,15230,3,2,1
1551,2013,Lisarow High School,15720,1,0,1
1552,2013,Lisarow High School,15320,2,1,1
1553,2013,Lisarow High School,15200,2,2,0
1554,2013,Lisarow High School,15710,1,0,1
1555,2013,Lisarow High School,15030,3,2,1
1556,2013,Lisarow High School,26599,2,0,2
1557,2013,Lisarow High School,15040,1,1,0
1558,2013,Lisarow High School,15060,3,0,3
1559,2013,Lisarow High School,15250,1,1,0
1560,2013,Lisarow High School,15220,2,2,0
1561,2013,Meriden School,15240,16,1,15
1562,2013,Meriden School,15270,7,0,7
1563,2013,Meriden School,15340,3,0,3
1564,2013,Meriden School,15170,3,0,3
1565,2013,Meriden School,15230,4,0,4
1566,2013,Meriden School,15190,3,0,3
1567,2013,Meriden School,15080,2,0,2
1568,2013,Meriden School,15830,1,0,1
1569,2013,Meriden School,15090,3,0,3
1570,2013,Meriden School,15320,2,0,2
1571,2013,Meriden School,15280,7,0,7
1572,2013,Meriden School,15160,7,0,7
1573,2013,Meriden School,15110,2,0,2
1574,2013,Meriden School,15910,1,0,1
1575,2013,Meriden School,15680,2,0,2
1576,2013,Meriden School,15260,3,0,3
1577,2013,Meriden School,15030,3,0,3
1578,2013,Meriden School,15310,1,0,1
1579,2013,Meriden School,26599,2,0,2
1580,2013,Meriden School,15330,1,0,1
1581,2013,Meriden School,15400,3,0,3
1582,2013,Meriden School,15555,2,0,2
1583,2013,Meriden School,15040,6,0,6
1584,2013,Meriden School,15060,2,0,2
1585,2013,Meriden School,15140,9,0,9
1586,2013,Meriden School,15050,2,0,2
1587,2013,Meriden School,15290,2,0,2
1588,2013,Meriden School,15250,12,1,11
1589,2013,Meriden School,15220,9,0,9
1590,2013,Meriden School,15020,6,0,6
1591,2013,Parramatta High School,15240,1,0,1
1592,2013,Parramatta High School,15350,1,0,1
1593,2013,Parramatta High School,15560,1,0,1
1594,2013,Parramatta High School,15260,1,1,0
1595,2013,Parramatta High School,15030,1,0,1
1596,2013,Parramatta High School,26599,2,0,2
1597,2013,Parramatta High School,15330,2,2,0
1598,2013,Parramatta High School,15060,2,0,2
1599,2013,Parramatta High School,15750,2,0,2
1600,2013,Parramatta High School,15140,1,0,1
1601,2013,Parramatta High School,15050,2,1,1
1602,2013,Parramatta High School,15250,4,2,2
1603,2013,Scone High School,15020,1,0,1
1604,2013,Kingsgrove North High School,15240,1,0,1
1605,2013,Kingsgrove North High School,15230,2,1,1
1606,2013,Kingsgrove North High School,15040,1,0,1
1607,2013,Kingsgrove North High School,15140,2,0,2
1608,2013,Kingsgrove North High School,15210,1,1,0
1609,2013,Kingsgrove North High School,15290,1,0,1
1610,2013,Kingsgrove North High School,15220,1,0,1
1611,2013,Kingsgrove North High School,15020,2,0,2
1612,2013,St Ives High School,15240,3,3,0
1613,2013,St Ives High School,15270,1,1,0
1614,2013,St Ives High School,15170,2,0,2
1615,2013,St Ives High School,15230,7,3,4
1616,2013,St Ives High School,15190,4,1,3
1617,2013,St Ives High School,16080,1,0,1
1618,2013,St Ives High School,15550,1,1,0
1619,2013,St Ives High School,15320,1,0,1
1620,2013,St Ives High School,15280,3,2,1
1621,2013,St Ives High School,15200,2,1,1
1622,2013,St Ives High School,15820,1,0,1
1623,2013,St Ives High School,15160,4,0,4
1624,2013,St Ives High School,15110,1,1,0
1625,2013,St Ives High School,15260,3,1,2
1626,2013,St Ives High School,15030,3,2,1
1627,2013,St Ives High School,15150,5,1,4
1628,2013,St Ives High School,15400,3,1,2
1629,2013,St Ives High School,15100,1,0,1
1630,2013,St Ives High School,15040,4,3,1
1631,2013,St Ives High School,15180,2,0,2
1632,2013,St Ives High School,15140,6,1,5
1633,2013,St Ives High School,15130,1,0,1
1634,2013,St Ives High School,15050,4,2,2
1635,2013,St Ives High School,15290,1,0,1
1636,2013,St Ives High School,15250,9,4,5
1637,2013,St Ives High School,15220,4,1,3
1638,2013,St Ives High School,15020,5,1,4
1639,2013,St Ives High School,15700,1,1,0
1640,2013,Pacific Hills Christian School,15240,7,2,5
1641,2013,Pacific Hills Christian School,15270,1,1,0
1642,2013,Pacific Hills Christian School,15170,1,0,1
1643,2013,Pacific Hills Christian School,15230,3,2,1
1644,2013,Pacific Hills Christian School,15320,1,0,1
1645,2013,Pacific Hills Christian School,15280,1,1,0
1646,2013,Pacific Hills Christian School,15380,1,1,0
1647,2013,Pacific Hills Christian School,15160,1,0,1
1648,2013,Pacific Hills Christian School,15300,1,1,0
1649,2013,Pacific Hills Christian School,15110,1,1,0
1650,2013,Pacific Hills Christian School,15260,2,2,0
1651,2013,Pacific Hills Christian School,15030,3,0,3
1652,2013,Pacific Hills Christian School,15370,1,1,0
1653,2013,Pacific Hills Christian School,15310,1,0,1
1654,2013,Pacific Hills Christian School,15330,3,2,1
1655,2013,Pacific Hills Christian School,15150,1,0,1
1656,2013,Pacific Hills Christian School,15400,1,0,1
1657,2013,Pacific Hills Christian School,15140,2,0,2
1658,2013,Pacific Hills Christian School,15050,4,2,2
1659,2013,Pacific Hills Christian School,15250,5,2,3
1660,2013,Davidson High School,15270,5,1,4
1661,2013,Davidson High School,15340,2,0,2
1662,2013,Davidson High School,15230,3,2,1
1663,2013,Davidson High School,15190,3,1,2
1664,2013,Davidson High School,15090,4,0,4
1665,2013,Davidson High School,15320,1,0,1
1666,2013,Davidson High School,15670,1,0,1
1667,2013,Davidson High School,15350,3,1,2
1668,2013,Davidson High School,15200,1,1,0
1669,2013,Davidson High School,15820,2,2,0
1670,2013,Davidson High School,15110,2,1,1
1671,2013,Davidson High School,15560,1,1,0
1672,2013,Davidson High School,15260,1,0,1
1673,2013,Davidson High School,15030,1,0,1
1674,2013,Davidson High School,15310,3,2,1
1675,2013,Davidson High School,26599,2,0,2
1676,2013,Davidson High School,15400,2,0,2
1677,2013,Davidson High School,15040,1,1,0
1678,2013,Davidson High School,15180,4,0,4
1679,2013,Davidson High School,15060,5,0,5
1680,2013,Davidson High School,15140,5,1,4
1681,2013,Davidson High School,15050,1,0,1
1682,2013,Davidson High School,15290,6,4,2
1683,2013,Davidson High School,15250,5,3,2
1684,2013,Davidson High School,15220,7,2,5
1685,2013,Hennessy Catholic College,15230,10,7,3
1686,2013,Hennessy Catholic College,15320,3,2,1
1687,2013,Hennessy Catholic College,15280,1,0,1
1688,2013,Hennessy Catholic College,15200,2,2,0
1689,2013,Hennessy Catholic College,15030,2,2,0
1690,2013,Hennessy Catholic College,15370,6,3,3
1691,2013,Hennessy Catholic College,26599,2,1,1
1692,2013,Hennessy Catholic College,15040,1,0,1
1693,2013,Hennessy Catholic College,15140,1,1,0
1694,2013,Hennessy Catholic College,15220,1,1,0
1695,2013,Hennessy Catholic College,15020,1,1,0
1696,2013,Moama Anglican Grammar School,15240,1,0,1
1697,2013,Moama Anglican Grammar School,15230,4,1,3
1698,2013,Moama Anglican Grammar School,15090,1,1,0
1699,2013,Moama Anglican Grammar School,15320,3,0,3
1700,2013,Moama Anglican Grammar School,15200,2,2,0
1701,2013,Moama Anglican Grammar School,15260,1,1,0
1702,2013,Moama Anglican Grammar School,15030,3,0,3
1703,2013,Moama Anglican Grammar School,15330,1,1,0
1704,2013,Moama Anglican Grammar School,15180,1,0,1
1705,2013,Moama Anglican Grammar School,15250,1,1,0
1706,2013,Moama Anglican Grammar School,15220,2,0,2
1707,2013,St Paul's College,15230,3,0,3
1708,2013,St Paul's College,15320,1,1,0
1709,2013,St Paul's College,15200,1,1,0
1710,2013,St Paul's College,15030,1,0,1
1711,2013,St Paul's College,15370,3,2,1
1712,2013,St Paul's College,15330,1,1,0
1713,2013,St Paul's College,15140,1,0,1
1714,2013,St Paul's College,15290,2,1,1
1715,2013,St Paul's College,15220,2,2,0
1716,2013,St Stanislaus' College,15240,1,1,0
1717,2013,St Stanislaus' College,26899,1,1,0
1718,2013,St Stanislaus' College,15270,3,3,0
1719,2013,St Stanislaus' College,15230,3,3,0
1720,2013,St Stanislaus' College,15370,1,1,0
1721,2013,St Stanislaus' College,15020,2,2,0
1722,2013,Ulladulla High School,15320,1,0,1
1723,2013,Ulladulla High School,15200,2,2,0
1724,2013,Ulladulla High School,15160,1,0,1
1725,2013,Ulladulla High School,15030,1,0,1
1726,2013,Ulladulla High School,15140,3,1,2
1727,2013,Ulladulla High School,15290,1,0,1
1728,2013,O'Connor Catholic College,15270,2,0,2
1729,2013,O'Connor Catholic College,15370,1,0,1
1730,2013,O'Connor Catholic College,15050,1,1,0
1731,2013,O'Connor Catholic College,15390,1,0,1
1732,2013,Northern Beaches Secondary College Balgowlah Boys Campus,15270,4,4,0
1733,2013,Northern Beaches Secondary College Balgowlah Boys Campus,15170,1,1,0
1734,2013,Northern Beaches Secondary College Balgowlah Boys Campus,15230,2,2,0
1735,2013,Northern Beaches Secondary College Balgowlah Boys Campus,15140,8,8,0
1736,2013,Northern Beaches Secondary College Balgowlah Boys Campus,15130,1,1,0
1737,2013,Sydney Grammar School,15240,19,19,0
1738,2013,Sydney Grammar School,15270,22,22,0
1739,2013,Sydney Grammar School,15170,11,11,0
1740,2013,Sydney Grammar School,15190,25,25,0
1741,2013,Sydney Grammar School,15550,4,4,0
1742,2013,Sydney Grammar School,15320,6,6,0
1743,2013,Sydney Grammar School,15280,11,11,0
1744,2013,Sydney Grammar School,15590,6,6,0
1745,2013,Sydney Grammar School,15820,2,2,0
1746,2013,Sydney Grammar School,15160,14,14,0
1747,2013,Sydney Grammar School,15300,8,7,1
1748,2013,Sydney Grammar School,15580,7,7,0
1749,2013,Sydney Grammar School,15110,20,20,0
1750,2013,Sydney Grammar School,15910,17,16,1
1751,2013,Sydney Grammar School,15710,2,2,0
1752,2013,Sydney Grammar School,15680,16,16,0
1753,2013,Sydney Grammar School,15260,41,41,0
1754,2013,Sydney Grammar School,15570,2,2,0
1755,2013,Sydney Grammar School,15900,18,17,1
1756,2013,Sydney Grammar School,15030,11,11,0
1757,2013,Sydney Grammar School,15370,2,2,0
1758,2013,Sydney Grammar School,15310,9,8,1
1759,2013,Sydney Grammar School,15810,2,2,0
1760,2013,Sydney Grammar School,15330,35,34,1
1761,2013,Sydney Grammar School,15400,11,11,0
1762,2013,Sydney Grammar School,15800,6,6,0
1763,2013,Sydney Grammar School,15140,54,54,0
1764,2013,Sydney Grammar School,15050,36,35,1
1765,2013,Sydney Grammar School,15290,3,3,0
1766,2013,Sydney Grammar School,15250,62,60,2
1767,2013,Sydney Grammar School,15690,14,14,0
1768,2013,Sydney Grammar School,15020,9,9,0
1769,2013,St Francis Xavier's College,15240,3,2,1
1770,2013,St Francis Xavier's College,15270,2,0,2
1771,2013,St Francis Xavier's College,15340,1,0,1
1772,2013,St Francis Xavier's College,15170,6,1,5
1773,2013,St Francis Xavier's College,15230,14,3,11
1774,2013,St Francis Xavier's College,15190,1,0,1
1775,2013,St Francis Xavier's College,15360,1,1,0
1776,2013,St Francis Xavier's College,15090,2,1,1
1777,2013,St Francis Xavier's College,15320,4,0,4
1778,2013,St Francis Xavier's College,15670,7,0,7
1779,2013,St Francis Xavier's College,15350,2,0,2
1780,2013,St Francis Xavier's College,15200,4,3,1
1781,2013,St Francis Xavier's College,15380,19,0,19
1782,2013,St Francis Xavier's College,15160,10,1,9
1783,2013,St Francis Xavier's College,15300,1,0,1
1784,2013,St Francis Xavier's College,15110,1,1,0
1785,2013,St Francis Xavier's College,15260,3,3,0
1786,2013,St Francis Xavier's College,15030,4,0,4
1787,2013,St Francis Xavier's College,15370,4,2,2
1788,2013,St Francis Xavier's College,15310,2,0,2
1789,2013,St Francis Xavier's College,15330,3,3,0
1790,2013,St Francis Xavier's College,15400,5,1,4
1791,2013,St Francis Xavier's College,15100,2,0,2
1792,2013,St Francis Xavier's College,15040,1,0,1
1793,2013,St Francis Xavier's College,15180,3,0,3
1794,2013,St Francis Xavier's College,15060,6,0,6
1795,2013,St Francis Xavier's College,15140,16,3,13
1796,2013,St Francis Xavier's College,15130,2,1,1
1797,2013,St Francis Xavier's College,15050,2,2,0
1798,2013,St Francis Xavier's College,15290,7,6,1
1799,2013,St Francis Xavier's College,15250,4,3,1
1800,2013,St Francis Xavier's College,15220,3,1,2
1801,2013,St Francis Xavier's College,15020,3,1,2
1802,2013,Wingham High School,15090,2,0,2
1803,2013,Northern Beaches Secondary College Cromer Campus,15160,1,0,1
1804,2013,Northern Beaches Secondary College Cromer Campus,27099,1,0,1
1805,2013,Northern Beaches Secondary College Cromer Campus,15250,2,2,0
1806,2013,Northern Beaches Secondary College Cromer Campus,15390,1,0,1
1807,2013,Bombala High School,15240,1,1,0
1808,2013,Bombala High School,15180,1,0,1
1809,2013,Trinity Anglican College - Albury,15240,3,3,0
1810,2013,Trinity Anglican College - Albury,15080,1,0,1
1811,2013,Trinity Anglican College - Albury,15320,3,0,3
1812,2013,Trinity Anglican College - Albury,26599,1,0,1
1813,2013,Trinity Anglican College - Albury,15330,2,2,0
1814,2013,Trinity Anglican College - Albury,15040,1,0,1
1815,2013,Trinity Anglican College - Albury,15250,2,2,0
1816,2013,Trinity Anglican College - Albury,15020,2,0,2
1817,2013,McCarthy Catholic College (Emu Plains),15260,1,1,0
1818,2013,McCarthy Catholic College (Emu Plains),15250,1,1,0
1819,2013,Thomas Reddall High School,15260,1,1,0
1820,2013,Thomas Reddall High School,15250,1,1,0
1821,2013,St John Bosco College,15240,5,5,0
1822,2013,St John Bosco College,15270,1,0,1
1823,2013,St John Bosco College,15170,2,0,2
1824,2013,St John Bosco College,15230,10,8,2
1825,2013,St John Bosco College,15190,3,3,0
1826,2013,St John Bosco College,15320,1,1,0
1827,2013,St John Bosco College,15160,1,0,1
1828,2013,St John Bosco College,15260,1,1,0
1829,2013,St John Bosco College,15030,1,0,1
1830,2013,St John Bosco College,15370,7,4,3
1831,2013,St John Bosco College,15330,1,1,0
1832,2013,St John Bosco College,15400,1,0,1
1833,2013,St John Bosco College,15040,4,3,1
1834,2013,St John Bosco College,15060,2,0,2
1835,2013,St John Bosco College,15140,3,1,2
1836,2013,St John Bosco College,15130,1,0,1
1837,2013,St John Bosco College,15290,2,1,1
1838,2013,St John Bosco College,15250,3,2,1
1839,2013,St John Bosco College,15220,1,0,1
1840,2013,St John Bosco College,15020,3,0,3
1841,2013,Marist College North Shore,15240,7,7,0
1842,2013,Marist College North Shore,15270,5,5,0
1843,2013,Marist College North Shore,15230,4,4,0
1844,2013,Marist College North Shore,15200,2,2,0
1845,2013,Marist College North Shore,15110,1,1,0
1846,2013,Marist College North Shore,15370,7,7,0
1847,2013,Marist College North Shore,26399,1,1,0
1848,2013,Marist College North Shore,15400,1,1,0
1849,2013,Marist College North Shore,15140,4,4,0
1850,2013,Marist College North Shore,15210,1,1,0
1851,2013,Marist College North Shore,15290,5,5,0
1852,2013,Marist College North Shore,15250,2,2,0
1853,2013,Marist College North Shore,15020,2,2,0
1854,2013,Holy Spirit College,15240,1,1,0
1855,2013,Holy Spirit College,15270,3,2,1
1856,2013,Holy Spirit College,15340,1,0,1
1857,2013,Holy Spirit College,15170,1,1,0
1858,2013,Holy Spirit College,15230,3,2,1
1859,2013,Holy Spirit College,15080,2,1,1
1860,2013,Holy Spirit College,15070,1,0,1
1861,2013,Holy Spirit College,15090,1,1,0
1862,2013,Holy Spirit College,15280,1,1,0
1863,2013,Holy Spirit College,15350,4,2,2
1864,2013,Holy Spirit College,15160,4,3,1
1865,2013,Holy Spirit College,15370,15,6,9
1866,2013,Holy Spirit College,26399,1,1,0
1867,2013,Holy Spirit College,15400,1,0,1
1868,2013,Holy Spirit College,15060,1,0,1
1869,2013,Holy Spirit College,15140,1,1,0
1870,2013,Holy Spirit College,15290,2,0,2
1871,2013,Holy Spirit College,15250,1,1,0
1872,2013,Warners Bay High School,15240,3,0,3
1873,2013,Warners Bay High School,15270,2,1,1
1874,2013,Warners Bay High School,15340,7,4,3
1875,2013,Warners Bay High School,26499,1,0,1
1876,2013,Warners Bay High School,15170,1,0,1
1877,2013,Warners Bay High School,15230,2,1,1
1878,2013,Warners Bay High School,15190,2,0,2
1879,2013,Warners Bay High School,15360,1,1,0
1880,2013,Warners Bay High School,15350,1,1,0
1881,2013,Warners Bay High School,15200,4,4,0
1882,2013,Warners Bay High School,15160,1,1,0
1883,2013,Warners Bay High School,15030,2,0,2
1884,2013,Warners Bay High School,15400,7,3,4
1885,2013,Warners Bay High School,15040,5,4,1
1886,2013,Warners Bay High School,15060,3,0,3
1887,2013,Warners Bay High School,15140,2,1,1
1888,2013,Warners Bay High School,15050,1,0,1
1889,2013,Warners Bay High School,15250,3,2,1
1890,2013,Warners Bay High School,15220,1,0,1
1891,2013,Warners Bay High School,15390,1,0,1
1892,2013,St Gregory's College Campbelltown,15240,4,4,0
1893,2013,St Gregory's College Campbelltown,26899,1,1,0
1894,2013,St Gregory's College Campbelltown,15340,1,1,0
1895,2013,St Gregory's College Campbelltown,15230,3,3,0
1896,2013,St Gregory's College Campbelltown,15080,3,3,0
1897,2013,St Gregory's College Campbelltown,15320,1,1,0
1898,2013,St Gregory's College Campbelltown,15200,5,5,0
1899,2013,St Gregory's College Campbelltown,15110,2,2,0
1900,2013,St Gregory's College Campbelltown,26699,1,1,0
1901,2013,St Gregory's College Campbelltown,15260,2,2,0
1902,2013,St Gregory's College Campbelltown,15030,3,3,0
1903,2013,St Gregory's College Campbelltown,15370,4,4,0
1904,2013,St Gregory's College Campbelltown,15330,1,1,0
1905,2013,St Gregory's College Campbelltown,15400,3,3,0
1906,2013,St Gregory's College Campbelltown,15040,3,3,0
1907,2013,St Gregory's College Campbelltown,15140,2,2,0
1908,2013,St Gregory's College Campbelltown,15130,1,1,0
1909,2013,St Gregory's College Campbelltown,15050,1,1,0
1910,2013,St Gregory's College Campbelltown,15210,2,2,0
1911,2013,St Gregory's College Campbelltown,15290,3,3,0
1912,2013,St Gregory's College Campbelltown,15250,3,3,0
1913,2013,St Gregory's College Campbelltown,15020,2,2,0
1914,2013,St Gregory's College Campbelltown,15010,2,2,0
1915,2013,Moorebank High School,15240,2,1,1
1916,2013,Moorebank High School,15230,2,1,1
1917,2013,Moorebank High School,15350,2,0,2
1918,2013,Moorebank High School,15260,1,1,0
1919,2013,Moorebank High School,15290,1,0,1
1920,2013,Moorebank High School,15250,2,2,0
1921,2013,Birrong Boys High School,15240,2,1,1
1922,2013,Birrong Boys High School,15230,1,1,0
1923,2013,Birrong Boys High School,15260,1,1,0
1924,2013,Birrong Boys High School,15040,1,1,0
1925,2013,Birrong Boys High School,15250,1,1,0
1926,2013,Loyola Senior High School,15660,1,0,1
1927,2013,Loyola Senior High School,15320,1,0,1
1928,2013,Loyola Senior High School,15260,1,0,1
1929,2013,Loyola Senior High School,15400,2,0,2
1930,2013,Loyola Senior High School,15140,1,0,1
1931,2013,Loyola Senior High School,15210,1,1,0
1932,2013,Loyola Senior High School,15250,2,1,1
1933,2013,Loyola Senior High School,15020,1,0,1
1934,2013,OTEN - Open Training and Education Network,15230,2,0,2
1935,2013,OTEN - Open Training and Education Network,15030,1,1,0
1936,2013,OTEN - Open Training and Education Network,15050,1,0,1
1937,2013,OTEN - Open Training and Education Network,15220,1,0,1
1938,2013,Batemans Bay High School,15240,1,1,0
1939,2013,Batemans Bay High School,15080,1,0,1
1940,2013,Batemans Bay High School,15680,1,0,1
1941,2013,Batemans Bay High School,15030,1,0,1
1942,2013,Batemans Bay High School,15400,1,0,1
1943,2013,Batemans Bay High School,15220,2,1,1
1944,2013,Batemans Bay High School,15020,2,0,2
1945,2013,Woolooware High School,15240,1,1,0
1946,2013,Woolooware High School,15270,1,1,0
1947,2013,Woolooware High School,15170,2,1,1
1948,2013,Woolooware High School,15230,6,4,2
1949,2013,Woolooware High School,15070,1,0,1
1950,2013,Woolooware High School,15320,2,0,2
1951,2013,Woolooware High School,15350,1,0,1
1952,2013,Woolooware High School,15200,4,2,2
1953,2013,Woolooware High School,15160,2,1,1
1954,2013,Woolooware High School,15300,1,1,0
1955,2013,Woolooware High School,15030,2,0,2
1956,2013,Woolooware High School,26599,1,1,0
1957,2013,Woolooware High School,15400,1,0,1
1958,2013,Woolooware High School,15040,1,1,0
1959,2013,Woolooware High School,15180,2,0,2
1960,2013,Woolooware High School,15060,1,0,1
1961,2013,Woolooware High School,15140,2,1,1
1962,2013,Woolooware High School,15290,1,1,0
1963,2013,Woolooware High School,15250,2,2,0
1964,2013,Woolooware High School,15220,1,1,0
1965,2013,Coffs Harbour Senior College,15240,2,2,0
1966,2013,Coffs Harbour Senior College,15270,2,0,2
1967,2013,Coffs Harbour Senior College,15340,2,0,2
1968,2013,Coffs Harbour Senior College,15170,1,0,1
1969,2013,Coffs Harbour Senior College,15230,4,2,2
1970,2013,Coffs Harbour Senior College,15120,1,1,0
1971,2013,Coffs Harbour Senior College,15320,2,1,1
1972,2013,Coffs Harbour Senior College,15280,2,0,2
1973,2013,Coffs Harbour Senior College,15670,1,1,0
1974,2013,Coffs Harbour Senior College,15350,2,1,1
1975,2013,Coffs Harbour Senior College,16070,1,0,1
1976,2013,Coffs Harbour Senior College,15160,2,0,2
1977,2013,Coffs Harbour Senior College,15260,1,1,0
1978,2013,Coffs Harbour Senior College,15030,2,1,1
1979,2013,Coffs Harbour Senior College,15370,1,0,1
1980,2013,Coffs Harbour Senior College,15310,1,0,1
1981,2013,Coffs Harbour Senior College,15330,4,3,1
1982,2013,Coffs Harbour Senior College,15400,3,0,3
1983,2013,Coffs Harbour Senior College,15140,1,1,0
1984,2013,Coffs Harbour Senior College,15050,1,1,0
1985,2013,Coffs Harbour Senior College,15250,3,3,0
1986,2013,Coffs Harbour Senior College,15020,5,2,3
1987,2013,Coffs Harbour Senior College,15390,3,1,2
1988,2013,Danebank - An Anglican School For Girls,15240,6,0,6
1989,2013,Danebank - An Anglican School For Girls,15270,2,0,2
1990,2013,Danebank - An Anglican School For Girls,15230,4,0,4
1991,2013,Danebank - An Anglican School For Girls,15080,3,0,3
1992,2013,Danebank - An Anglican School For Girls,15320,2,0,2
1993,2013,Danebank - An Anglican School For Girls,15160,3,0,3
1994,2013,Danebank - An Anglican School For Girls,15110,2,0,2
1995,2013,Danebank - An Anglican School For Girls,15560,2,0,2
1996,2013,Danebank - An Anglican School For Girls,15030,4,0,4
1997,2013,Danebank - An Anglican School For Girls,15790,1,0,1
1998,2013,Danebank - An Anglican School For Girls,26599,1,0,1
1999,2013,Danebank - An Anglican School For Girls,15970,1,0,1
2000,2013,Danebank - An Anglican School For Girls,15400,7,1,6
2001,2013,Danebank - An Anglican School For Girls,15040,6,0,6
2002,2013,Danebank - An Anglican School For Girls,15140,2,0,2
2003,2013,Danebank - An Anglican School For Girls,15130,1,0,1
2004,2013,Danebank - An Anglican School For Girls,15050,6,0,6
2005,2013,Danebank - An Anglican School For Girls,15290,1,0,1
2006,2013,Danebank - An Anglican School For Girls,15250,5,0,5
2007,2013,Danebank - An Anglican School For Girls,15220,9,0,9
2008,2013,Danebank - An Anglican School For Girls,15390,1,0,1
2009,2013,Ku-ring-gai High School,15230,7,2,5
2010,2013,Ku-ring-gai High School,16080,2,1,1
2011,2013,Ku-ring-gai High School,15360,1,1,0
2012,2013,Ku-ring-gai High School,15320,2,0,2
2013,2013,Ku-ring-gai High School,15640,1,1,0
2014,2013,Ku-ring-gai High School,16010,1,1,0
2015,2013,Ku-ring-gai High School,15030,1,0,1
2016,2013,Ku-ring-gai High School,15400,2,1,1
2017,2013,Ku-ring-gai High School,15060,1,0,1
2018,2013,Ku-ring-gai High School,15290,1,0,1
2019,2013,Ku-ring-gai High School,15220,1,0,1
2020,2013,Ku-ring-gai High School,15390,2,0,2
2021,2013,Chifley College Senior Campus,15230,1,1,0
2022,2013,Chifley College Senior Campus,15670,1,0,1
2023,2013,Chifley College Senior Campus,15510,1,0,1
2024,2013,Chifley College Senior Campus,15040,1,0,1
2025,2013,Chifley College Senior Campus,15520,1,0,1
2026,2013,Chifley College Senior Campus,15290,1,1,0
2027,2013,The Henry Lawson High School,15250,1,1,0
2028,2013,St Peter's Anglican College - Broulee,15240,2,1,1
2029,2013,St Peter's Anglican College - Broulee,15230,2,1,1
2030,2013,St Peter's Anglican College - Broulee,15160,1,0,1
2031,2013,St Peter's Anglican College - Broulee,15030,1,0,1
2032,2013,St Peter's Anglican College - Broulee,15140,2,0,2
2033,2013,St Peter's Anglican College - Broulee,15220,2,0,2
2034,2013,Cedars Christian College,15240,1,0,1
2035,2013,Cedars Christian College,15080,1,0,1
2036,2013,Cedars Christian College,15320,1,1,0
2037,2013,Randwick Boys High School,16080,1,1,0
2038,2013,Randwick Boys High School,15320,1,1,0
2039,2013,Randwick Boys High School,15160,1,1,0
2040,2013,Randwick Boys High School,15030,1,1,0
2041,2013,Randwick Boys High School,15040,1,1,0
2042,2013,Randwick Boys High School,15140,1,1,0
2043,2013,Randwick Boys High School,15050,2,2,0
2044,2013,Randwick Boys High School,15210,1,1,0
2045,2013,Randwick Boys High School,15290,2,1,1
2046,2013,Randwick Boys High School,15250,1,1,0
2047,2013,Randwick Boys High School,15020,1,1,0
2048,2013,Australian International School Hong Kong,15240,3,1,2
2049,2013,Australian International School Hong Kong,15270,1,1,0
2050,2013,Australian International School Hong Kong,15170,2,0,2
2051,2013,Australian International School Hong Kong,15230,8,3,5
2052,2013,Australian International School Hong Kong,15080,2,0,2
2053,2013,Australian International School Hong Kong,15670,1,0,1
2054,2013,Australian International School Hong Kong,15110,1,0,1
2055,2013,Australian International School Hong Kong,15260,2,1,1
2056,2013,Australian International School Hong Kong,15030,1,0,1
2057,2013,Australian International School Hong Kong,15310,1,0,1
2058,2013,Australian International School Hong Kong,15330,1,0,1
2059,2013,Australian International School Hong Kong,15040,4,2,2
2060,2013,Australian International School Hong Kong,15140,3,0,3
2061,2013,Australian International School Hong Kong,15050,2,0,2
2062,2013,Australian International School Hong Kong,15210,2,0,2
2063,2013,Australian International School Hong Kong,15250,2,1,1
2064,2013,Australian International School Hong Kong,15220,1,0,1
2065,2013,Evans River Community School,15290,1,0,1
2066,2013,Evans River Community School,15390,1,0,1
2067,2013,Kiama High School,15240,3,2,1
2068,2013,Kiama High School,15270,1,1,0
2069,2013,Kiama High School,15170,2,0,2
2070,2013,Kiama High School,15230,4,2,2
2071,2013,Kiama High School,15190,1,0,1
2072,2013,Kiama High School,15360,1,1,0
2073,2013,Kiama High School,15320,4,0,4
2074,2013,Kiama High School,15670,4,0,4
2075,2013,Kiama High School,15200,2,2,0
2076,2013,Kiama High School,15160,2,0,2
2077,2013,Kiama High School,15030,2,0,2
2078,2013,Kiama High School,26599,1,0,1
2079,2013,Kiama High School,15330,1,1,0
2080,2013,Kiama High School,15400,7,2,5
2081,2013,Kiama High School,15100,3,0,3
2082,2013,Kiama High School,15800,2,0,2
2083,2013,Kiama High School,15140,4,1,3
2084,2013,Kiama High School,15050,2,1,1
2085,2013,Kiama High School,15210,1,1,0
2086,2013,Kiama High School,15290,7,5,2
2087,2013,Kiama High School,15250,1,1,0
2088,2013,Kiama High School,15220,2,0,2
2089,2013,Kiama High School,15390,1,0,1
2090,2013,Campbelltown Performing Arts High School,15240,1,1,0
2091,2013,Campbelltown Performing Arts High School,26699,2,2,0
2092,2013,Campbelltown Performing Arts High School,15290,2,1,1
2093,2013,Avondale School,15240,5,4,1
2094,2013,Avondale School,15270,1,0,1
2095,2013,Avondale School,15230,2,2,0
2096,2013,Avondale School,26699,1,1,0
2097,2013,Avondale School,15030,1,0,1
2098,2013,Avondale School,15370,5,2,3
2099,2013,Avondale School,26599,2,0,2
2100,2013,Avondale School,15060,1,0,1
2101,2013,Avondale School,26099,1,1,0
2102,2013,Avondale School,15290,3,2,1
2103,2013,Avondale School,15250,2,1,1
2104,2013,Avondale School,15020,1,0,1
2105,2013,Avondale School,15390,1,0,1
2106,2013,Northmead Creative and Performing Arts High School,15240,1,1,0
2107,2013,Northmead Creative and Performing Arts High School,15230,1,1,0
2108,2013,Northmead Creative and Performing Arts High School,15070,1,0,1
2109,2013,Northmead Creative and Performing Arts High School,15260,1,1,0
2110,2013,Northmead Creative and Performing Arts High School,15030,1,1,0
2111,2013,Northmead Creative and Performing Arts High School,15310,1,1,0
2112,2013,Northmead Creative and Performing Arts High School,15180,1,0,1
2113,2013,Northmead Creative and Performing Arts High School,15060,1,0,1
2114,2013,Northmead Creative and Performing Arts High School,15290,1,0,1
2115,2013,Northmead Creative and Performing Arts High School,15250,1,1,0
2116,2013,Hurlstone Agricultural High School,15240,40,21,19
2117,2013,Hurlstone Agricultural High School,26899,1,0,1
2118,2013,Hurlstone Agricultural High School,15270,5,1,4
2119,2013,Hurlstone Agricultural High School,15340,43,21,22
2120,2013,Hurlstone Agricultural High School,15170,2,0,2
2121,2013,Hurlstone Agricultural High School,15230,16,5,11
2122,2013,Hurlstone Agricultural High School,15120,3,2,1
2123,2013,Hurlstone Agricultural High School,15320,2,0,2
2124,2013,Hurlstone Agricultural High School,15160,4,2,2
2125,2013,Hurlstone Agricultural High School,15110,9,3,6
2126,2013,Hurlstone Agricultural High School,15260,18,12,6
2127,2013,Hurlstone Agricultural High School,15030,10,4,6
2128,2013,Hurlstone Agricultural High School,15330,18,15,3
2129,2013,Hurlstone Agricultural High School,15400,4,2,2
2130,2013,Hurlstone Agricultural High School,15040,12,8,4
2131,2013,Hurlstone Agricultural High School,15140,14,5,9
2132,2013,Hurlstone Agricultural High School,15050,36,18,18
2133,2013,Hurlstone Agricultural High School,15290,5,4,1
2134,2013,Hurlstone Agricultural High School,15250,42,24,18
2135,2013,Hurlstone Agricultural High School,15220,9,3,6
2136,2013,Hurlstone Agricultural High School,15020,1,0,1
2137,2013,Hurlstone Agricultural High School,15010,33,14,19
2138,2013,Red Bend Catholic College,15240,1,1,0
2139,2013,Red Bend Catholic College,15260,1,1,0
2140,2013,Red Bend Catholic College,15370,8,6,2
2141,2013,Red Bend Catholic College,15330,1,1,0
2142,2013,Red Bend Catholic College,15040,1,1,0
2143,2013,Red Bend Catholic College,15060,2,0,2
2144,2013,Red Bend Catholic College,15290,2,0,2
2145,2013,Red Bend Catholic College,15250,1,1,0
2146,2013,Red Bend Catholic College,15220,3,1,2
2147,2013,Red Bend Catholic College,15010,1,0,1
2148,2013,Blakehurst High School,15240,3,3,0
2149,2013,Blakehurst High School,15230,6,3,3
2150,2013,Blakehurst High School,15320,1,0,1
2151,2013,Blakehurst High School,15200,1,0,1
2152,2013,Blakehurst High School,15820,2,0,2
2153,2013,Blakehurst High School,15940,2,0,2
2154,2013,Blakehurst High School,15560,4,0,4
2155,2013,Blakehurst High School,15260,3,1,2
2156,2013,Blakehurst High School,15030,1,0,1
2157,2013,Blakehurst High School,15790,1,0,1
2158,2013,Blakehurst High School,26599,1,1,0
2159,2013,Blakehurst High School,15330,2,1,1
2160,2013,Blakehurst High School,15100,2,0,2
2161,2013,Blakehurst High School,15040,2,1,1
2162,2013,Blakehurst High School,15180,2,0,2
2163,2013,Blakehurst High School,15060,4,0,4
2164,2013,Blakehurst High School,15050,2,0,2
2165,2013,Blakehurst High School,15250,8,3,5
2166,2013,Blakehurst High School,15020,2,0,2
2167,2013,Blakehurst High School,15390,3,0,3
2168,2013,Calrossy Anglican School,15240,2,2,0
2169,2013,Calrossy Anglican School,26899,2,0,2
2170,2013,Calrossy Anglican School,15270,2,0,2
2171,2013,Calrossy Anglican School,15340,7,1,6
2172,2013,Calrossy Anglican School,15230,1,0,1
2173,2013,Calrossy Anglican School,15190,3,0,3
2174,2013,Calrossy Anglican School,15200,1,1,0
2175,2013,Calrossy Anglican School,15030,1,0,1
2176,2013,Calrossy Anglican School,26599,1,0,1
2177,2013,Calrossy Anglican School,15290,3,2,1
2178,2013,Calrossy Anglican School,15250,1,1,0
2179,2013,Calrossy Anglican School,15390,1,0,1
2180,2013,Calrossy Anglican School,15010,4,0,4
2181,2013,Figtree High School,15270,1,0,1
2182,2013,Figtree High School,15170,1,1,0
2183,2013,Figtree High School,15230,2,2,0
2184,2013,Figtree High School,15190,1,1,0
2185,2013,Figtree High School,15320,1,1,0
2186,2013,Figtree High School,15280,1,0,1
2187,2013,Figtree High School,15350,4,1,3
2188,2013,Figtree High School,15160,1,0,1
2189,2013,Figtree High School,15110,2,2,0
2190,2013,Figtree High School,16050,1,0,1
2191,2013,Figtree High School,15710,1,0,1
2192,2013,Figtree High School,15330,1,1,0
2193,2013,Figtree High School,15040,2,2,0
2194,2013,Figtree High School,15140,1,0,1
2195,2013,Figtree High School,15210,1,1,0
2196,2013,Figtree High School,15290,4,2,2
2197,2013,Figtree High School,15220,1,0,1
2198,2013,Figtree High School,15020,2,0,2
2199,2013,Rouse Hill High School,15240,1,1,0
2200,2013,Rouse Hill High School,15230,1,0,1
2201,2013,Rouse Hill High School,15210,1,1,0
2202,2013,Willyama High School,15320,1,1,0
2203,2013,Willyama High School,15350,1,0,1
2204,2013,Willyama High School,15060,1,0,1
2205,2013,Cerdon College,15240,6,1,5
2206,2013,Cerdon College,15270,3,0,3
2207,2013,Cerdon College,15230,6,0,6
2208,2013,Cerdon College,15190,1,0,1
2209,2013,Cerdon College,15090,1,0,1
2210,2013,Cerdon College,15320,6,0,6
2211,2013,Cerdon College,15280,3,0,3
2212,2013,Cerdon College,15380,6,0,6
2213,2013,Cerdon College,15160,5,0,5
2214,2013,Cerdon College,15110,2,0,2
2215,2013,Cerdon College,16020,1,0,1
2216,2013,Cerdon College,15030,3,0,3
2217,2013,Cerdon College,15370,27,2,25
2218,2013,Cerdon College,15620,1,0,1
2219,2013,Cerdon College,26599,1,0,1
2220,2013,Cerdon College,15400,5,0,5
2221,2013,Cerdon College,15040,4,0,4
2222,2013,Cerdon College,15180,4,0,4
2223,2013,Cerdon College,15060,13,0,13
2224,2013,Cerdon College,15140,29,1,28
2225,2013,Cerdon College,15050,2,0,2
2226,2013,Cerdon College,15290,4,0,4
2227,2013,Cerdon College,15250,1,0,1
2228,2013,Cerdon College,15220,17,1,16
2229,2013,Cerdon College,15020,4,0,4
2230,2013,St George Christian School,15240,4,3,1
2231,2013,St George Christian School,15230,2,1,1
2232,2013,St George Christian School,15190,1,0,1
2233,2013,St George Christian School,15080,4,0,4
2234,2013,St George Christian School,15090,1,0,1
2235,2013,St George Christian School,15280,1,1,0
2236,2013,St George Christian School,15160,2,0,2
2237,2013,St George Christian School,15680,2,0,2
2238,2013,St George Christian School,15260,1,0,1
2239,2013,St George Christian School,15330,1,0,1
2240,2013,St George Christian School,15040,1,1,0
2241,2013,St George Christian School,15060,1,0,1
2242,2013,St George Christian School,15140,1,0,1
2243,2013,St George Christian School,15290,1,0,1
2244,2013,St George Christian School,15250,3,3,0
2245,2013,Newcastle Grammar School,15240,1,0,1
2246,2013,Newcastle Grammar School,15270,4,1,3
2247,2013,Newcastle Grammar School,15170,4,1,3
2248,2013,Newcastle Grammar School,15230,5,1,4
2249,2013,Newcastle Grammar School,15190,22,11,11
2250,2013,Newcastle Grammar School,15080,6,3,3
2251,2013,Newcastle Grammar School,15090,3,0,3
2252,2013,Newcastle Grammar School,15320,2,0,2
2253,2013,Newcastle Grammar School,15280,3,1,2
2254,2013,Newcastle Grammar School,15380,1,0,1
2255,2013,Newcastle Grammar School,15160,7,2,5
2256,2013,Newcastle Grammar School,15300,1,0,1
2257,2013,Newcastle Grammar School,15110,1,1,0
2258,2013,Newcastle Grammar School,15680,3,0,3
2259,2013,Newcastle Grammar School,15030,1,0,1
2260,2013,Newcastle Grammar School,15310,6,2,4
2261,2013,Newcastle Grammar School,26599,1,0,1
2262,2013,Newcastle Grammar School,15330,3,1,2
2263,2013,Newcastle Grammar School,15400,5,0,5
2264,2013,Newcastle Grammar School,15040,2,1,1
2265,2013,Newcastle Grammar School,15140,14,2,12
2266,2013,Newcastle Grammar School,15050,2,0,2
2267,2013,Newcastle Grammar School,15210,3,3,0
2268,2013,Newcastle Grammar School,15290,1,0,1
2269,2013,Newcastle Grammar School,15250,2,0,2
2270,2013,Newcastle Grammar School,15220,2,1,1
2271,2013,Newcastle Grammar School,15020,4,1,3
2272,2013,Tangara School for Girls,15240,2,0,2
2273,2013,Tangara School for Girls,15270,4,0,4
2274,2013,Tangara School for Girls,15230,7,0,7
2275,2013,Tangara School for Girls,15190,2,0,2
2276,2013,Tangara School for Girls,16080,1,0,1
2277,2013,Tangara School for Girls,15160,1,0,1
2278,2013,Tangara School for Girls,16090,1,0,1
2279,2013,Tangara School for Girls,15030,2,0,2
2280,2013,Tangara School for Girls,15330,1,0,1
2281,2013,Tangara School for Girls,15400,1,0,1
2282,2013,Tangara School for Girls,15140,1,0,1
2283,2013,Tangara School for Girls,15130,1,0,1
2284,2013,Tangara School for Girls,15050,1,0,1
2285,2013,Tangara School for Girls,15290,3,0,3
2286,2013,Tangara School for Girls,15250,1,0,1
2287,2013,Tangara School for Girls,15020,1,0,1
2288,2013,Denison College of Secondary Education Kelso High Campus,26899,1,0,1
2289,2013,Denison College of Secondary Education Kelso High Campus,15230,2,1,1
2290,2013,Denison College of Secondary Education Kelso High Campus,15060,1,1,0
2291,2013,St Mary and St Mina's Coptic Orthodox College,15260,5,2,3
2292,2013,St Mary and St Mina's Coptic Orthodox College,15810,1,1,0
2293,2013,St Mary and St Mina's Coptic Orthodox College,15330,1,1,0
2294,2013,St Mary and St Mina's Coptic Orthodox College,15800,1,1,0
2295,2013,St Mary and St Mina's Coptic Orthodox College,15250,7,4,3
2296,2013,Cape Byron Rudolf Steiner School,15830,1,0,1
2297,2013,Cape Byron Rudolf Steiner School,15090,2,0,2
2298,2013,Cape Byron Rudolf Steiner School,15400,1,0,1
2299,2013,Cape Byron Rudolf Steiner School,15290,1,0,1
2300,2013,Malek Fahd Islamic School,15240,38,17,21
2301,2013,Malek Fahd Islamic School,15230,8,2,6
2302,2013,Malek Fahd Islamic School,15260,6,1,5
2303,2013,Malek Fahd Islamic School,15030,31,13,18
2304,2013,Malek Fahd Islamic School,15330,2,1,1
2305,2013,Malek Fahd Islamic School,15040,6,1,5
2306,2013,Malek Fahd Islamic School,15140,5,2,3
2307,2013,Malek Fahd Islamic School,15050,2,1,1
2308,2013,Malek Fahd Islamic School,15250,10,3,7
2309,2013,Sydney Technical High School,15240,27,27,0
2310,2013,Sydney Technical High School,15270,5,5,0
2311,2013,Sydney Technical High School,15080,3,3,0
2312,2013,Sydney Technical High School,15830,1,1,0
2313,2013,Sydney Technical High School,15120,8,8,0
2314,2013,Sydney Technical High School,15360,2,2,0
2315,2013,Sydney Technical High School,15320,1,1,0
2316,2013,Sydney Technical High School,15280,1,1,0
2317,2013,Sydney Technical High School,15160,5,5,0
2318,2013,Sydney Technical High School,15110,12,12,0
2319,2013,Sydney Technical High School,15680,1,1,0
2320,2013,Sydney Technical High School,15260,26,26,0
2321,2013,Sydney Technical High School,15030,4,4,0
2322,2013,Sydney Technical High School,15310,3,3,0
2323,2013,Sydney Technical High School,15970,1,1,0
2324,2013,Sydney Technical High School,15330,12,11,1
2325,2013,Sydney Technical High School,15400,7,7,0
2326,2013,Sydney Technical High School,15040,11,11,0
2327,2013,Sydney Technical High School,15140,11,11,0
2328,2013,Sydney Technical High School,15050,11,11,0
2329,2013,Sydney Technical High School,15210,6,6,0
2330,2013,Sydney Technical High School,15250,52,51,1
2331,2013,Sydney Technical High School,15220,5,5,0
2332,2013,Marsden High School,15240,1,1,0
2333,2013,Marsden High School,15260,1,1,0
2334,2013,Marsden High School,15030,1,1,0
2335,2013,Marsden High School,15040,1,1,0
2336,2013,Marsden High School,15050,3,3,0
2337,2013,Marsden High School,15250,2,2,0
2338,2013,SCEGGS Darlinghurst,15240,29,1,28
2339,2013,SCEGGS Darlinghurst,15270,21,1,20
2340,2013,SCEGGS Darlinghurst,15170,5,0,5
2341,2013,SCEGGS Darlinghurst,15230,4,0,4
2342,2013,SCEGGS Darlinghurst,15190,1,0,1
2343,2013,SCEGGS Darlinghurst,15830,1,0,1
2344,2013,SCEGGS Darlinghurst,15090,10,0,10
2345,2013,SCEGGS Darlinghurst,15320,3,0,3
2346,2013,SCEGGS Darlinghurst,15280,3,1,2
2347,2013,SCEGGS Darlinghurst,15160,18,0,18
2348,2013,SCEGGS Darlinghurst,15110,2,0,2
2349,2013,SCEGGS Darlinghurst,15680,12,0,12
2350,2013,SCEGGS Darlinghurst,15260,2,0,2
2351,2013,SCEGGS Darlinghurst,15030,4,0,4
2352,2013,SCEGGS Darlinghurst,15330,1,0,1
2353,2013,SCEGGS Darlinghurst,15400,20,1,19
2354,2013,SCEGGS Darlinghurst,15040,6,0,6
2355,2013,SCEGGS Darlinghurst,15140,37,1,36
2356,2013,SCEGGS Darlinghurst,15050,9,0,9
2357,2013,SCEGGS Darlinghurst,15210,1,0,1
2358,2013,SCEGGS Darlinghurst,15290,3,0,3
2359,2013,SCEGGS Darlinghurst,15250,11,0,11
2360,2013,SCEGGS Darlinghurst,15690,4,0,4
2361,2013,SCEGGS Darlinghurst,15020,18,0,18
2362,2013,SCEGGS Darlinghurst,15700,5,0,5
2363,2013,Karabar High School Distance Education Centre,15240,1,1,0
2364,2013,Karabar High School Distance Education Centre,15300,3,1,2
2365,2013,Karabar High School Distance Education Centre,15310,1,1,0
2366,2013,Karabar High School Distance Education Centre,15690,1,0,1
2367,2013,Ardlethan Central School,15290,2,0,2
2368,2013,St Maroun's College,15370,1,0,1
2369,2013,St Maroun's College,15040,1,0,1
2370,2013,St Maroun's College,15210,1,0,1
2371,2013,The Armidale School,15240,2,2,0
2372,2013,The Armidale School,15230,2,2,0
2373,2013,The Armidale School,15190,1,1,0
2374,2013,The Armidale School,15280,2,2,0
2375,2013,The Armidale School,15160,5,5,0
2376,2013,The Armidale School,15110,2,2,0
2377,2013,The Armidale School,15260,1,1,0
2378,2013,The Armidale School,15330,2,2,0
2379,2013,The Armidale School,15400,1,1,0
2380,2013,The Armidale School,15040,1,1,0
2381,2013,The Armidale School,15140,6,6,0
2382,2013,The Armidale School,15050,1,1,0
2383,2013,The Armidale School,15290,1,1,0
2384,2013,The Armidale School,15250,2,2,0
2385,2013,The Armidale School,15020,3,3,0
2386,2013,Westport High School,15240,1,1,0
2387,2013,Westport High School,15340,3,2,1
2388,2013,Westport High School,15230,1,1,0
2389,2013,Westport High School,15320,1,1,0
2390,2013,Westport High School,15330,1,1,0
2391,2013,Westport High School,15290,1,1,0
2392,2013,The Hills Grammar School,15240,2,0,2
2393,2013,The Hills Grammar School,15170,4,0,4
2394,2013,The Hills Grammar School,15230,1,0,1
2395,2013,The Hills Grammar School,15190,4,1,3
2396,2013,The Hills Grammar School,15080,2,0,2
2397,2013,The Hills Grammar School,15320,1,0,1
2398,2013,The Hills Grammar School,15280,1,0,1
2399,2013,The Hills Grammar School,15200,3,3,0
2400,2013,The Hills Grammar School,15160,2,0,2
2401,2013,The Hills Grammar School,15110,1,0,1
2402,2013,The Hills Grammar School,15910,2,0,2
2403,2013,The Hills Grammar School,26699,2,2,0
2404,2013,The Hills Grammar School,15260,4,1,3
2405,2013,The Hills Grammar School,15900,2,1,1
2406,2013,The Hills Grammar School,15310,1,0,1
2407,2013,The Hills Grammar School,15330,2,1,1
2408,2013,The Hills Grammar School,15150,1,0,1
2409,2013,The Hills Grammar School,15400,4,0,4
2410,2013,The Hills Grammar School,15040,6,2,4
2411,2013,The Hills Grammar School,15140,6,2,4
2412,2013,The Hills Grammar School,15050,2,0,2
2413,2013,The Hills Grammar School,15250,4,1,3
2414,2013,The Hills Grammar School,15220,2,0,2
2415,2013,The Hills Grammar School,15020,1,0,1
2416,2013,Corpus Christi Catholic High School,15240,3,2,1
2417,2013,Corpus Christi Catholic High School,15230,2,0,2
2418,2013,Corpus Christi Catholic High School,15080,4,3,1
2419,2013,Corpus Christi Catholic High School,15200,2,2,0
2420,2013,Corpus Christi Catholic High School,15380,2,1,1
2421,2013,Corpus Christi Catholic High School,15160,1,0,1
2422,2013,Corpus Christi Catholic High School,15370,3,1,2
2423,2013,Corpus Christi Catholic High School,26599,1,0,1
2424,2013,Corpus Christi Catholic High School,15330,1,1,0
2425,2013,Corpus Christi Catholic High School,15040,2,1,1
2426,2013,Corpus Christi Catholic High School,15140,4,2,2
2427,2013,Corpus Christi Catholic High School,15210,1,1,0
2428,2013,Corpus Christi Catholic High School,15250,2,1,1
2429,2013,Corpus Christi Catholic High School,15220,1,0,1
2430,2013,Corpus Christi Catholic High School,15020,2,0,2
2431,2013,James Sheahan Catholic High School,15240,5,2,3
2432,2013,James Sheahan Catholic High School,15270,2,0,2
2433,2013,James Sheahan Catholic High School,15230,2,0,2
2434,2013,James Sheahan Catholic High School,15190,2,1,1
2435,2013,James Sheahan Catholic High School,15120,1,1,0
2436,2013,James Sheahan Catholic High School,15320,1,1,0
2437,2013,James Sheahan Catholic High School,15380,3,0,3
2438,2013,James Sheahan Catholic High School,15160,1,0,1
2439,2013,James Sheahan Catholic High School,15300,2,0,2
2440,2013,James Sheahan Catholic High School,15030,1,0,1
2441,2013,James Sheahan Catholic High School,15370,4,1,3
2442,2013,James Sheahan Catholic High School,15310,1,0,1
2443,2013,James Sheahan Catholic High School,26599,1,0,1
2444,2013,James Sheahan Catholic High School,15400,1,0,1
2445,2013,James Sheahan Catholic High School,15060,5,0,5
2446,2013,James Sheahan Catholic High School,15140,4,1,3
2447,2013,James Sheahan Catholic High School,15290,3,2,1
2448,2013,James Sheahan Catholic High School,15220,2,0,2
2449,2013,James Sheahan Catholic High School,15020,1,0,1
2450,2013,Maitland Grossmann High School,15240,4,2,2
2451,2013,Maitland Grossmann High School,15270,2,0,2
2452,2013,Maitland Grossmann High School,15230,1,0,1
2453,2013,Maitland Grossmann High School,15120,2,2,0
2454,2013,Maitland Grossmann High School,15350,1,0,1
2455,2013,Maitland Grossmann High School,15200,9,8,1
2456,2013,Maitland Grossmann High School,15110,1,1,0
2457,2013,Maitland Grossmann High School,15260,2,2,0
2458,2013,Maitland Grossmann High School,15030,2,1,1
2459,2013,Maitland Grossmann High School,15330,2,2,0
2460,2013,Maitland Grossmann High School,15400,2,0,2
2461,2013,Maitland Grossmann High School,15040,1,1,0
2462,2013,Maitland Grossmann High School,15180,4,0,4
2463,2013,Maitland Grossmann High School,15060,3,0,3
2464,2013,Maitland Grossmann High School,15140,1,0,1
2465,2013,Maitland Grossmann High School,15130,2,1,1
2466,2013,Maitland Grossmann High School,15050,1,1,0
2467,2013,Maitland Grossmann High School,15290,3,3,0
2468,2013,Maitland Grossmann High School,15250,5,4,1
2469,2013,Maitland Grossmann High School,15220,1,0,1
2470,2013,Maitland Grossmann High School,15390,1,0,1
2471,2013,Toongabbie Christian School,15230,2,1,1
2472,2013,Toongabbie Christian School,15350,1,0,1
2473,2013,Toongabbie Christian School,15030,3,3,0
2474,2013,Toongabbie Christian School,15370,2,1,1
2475,2013,Toongabbie Christian School,15330,2,2,0
2476,2013,Toongabbie Christian School,15040,1,1,0
2477,2013,Toongabbie Christian School,15140,2,2,0
2478,2013,Toongabbie Christian School,15290,1,1,0
2479,2013,Toongabbie Christian School,15250,1,1,0
2480,2013,Queanbeyan High School,15240,1,1,0
2481,2013,Hunter Valley Grammar School,15240,4,2,2
2482,2013,Hunter Valley Grammar School,15270,3,0,3
2483,2013,Hunter Valley Grammar School,15340,5,2,3
2484,2013,Hunter Valley Grammar School,15170,1,1,0
2485,2013,Hunter Valley Grammar School,15230,9,4,5
2486,2013,Hunter Valley Grammar School,15190,1,0,1
2487,2013,Hunter Valley Grammar School,15120,3,2,1
2488,2013,Hunter Valley Grammar School,15090,6,2,4
2489,2013,Hunter Valley Grammar School,15320,3,1,2
2490,2013,Hunter Valley Grammar School,15280,1,0,1
2491,2013,Hunter Valley Grammar School,15380,4,1,3
2492,2013,Hunter Valley Grammar School,15160,5,3,2
2493,2013,Hunter Valley Grammar School,15300,1,1,0
2494,2013,Hunter Valley Grammar School,15030,6,1,5
2495,2013,Hunter Valley Grammar School,15310,1,1,0
2496,2013,Hunter Valley Grammar School,26599,1,0,1
2497,2013,Hunter Valley Grammar School,15330,4,2,2
2498,2013,Hunter Valley Grammar School,15400,1,0,1
2499,2013,Hunter Valley Grammar School,15100,2,1,1
2500,2013,Hunter Valley Grammar School,15040,3,2,1
2501,2013,Hunter Valley Grammar School,15060,3,1,2
2502,2013,Hunter Valley Grammar School,15140,5,3,2
2503,2013,Hunter Valley Grammar School,15290,8,5,3
2504,2013,Hunter Valley Grammar School,15250,4,2,2
2505,2013,Hunter Valley Grammar School,15220,1,1,0
2506,2013,Hunter Valley Grammar School,15020,4,2,2
2507,2013,Hunter Valley Grammar School,15390,3,0,3
2508,2013,Holmes Secondary College,15240,1,0,1
2509,2013,Holmes Secondary College,15560,1,0,1
2510,2013,Holmes Secondary College,15250,2,0,2
2511,2013,East Hills Girls Technology High School,15240,1,0,1
2512,2013,East Hills Girls Technology High School,15340,2,0,2
2513,2013,East Hills Girls Technology High School,26499,1,0,1
2514,2013,East Hills Girls Technology High School,15230,10,1,9
2515,2013,East Hills Girls Technology High School,15090,1,0,1
2516,2013,East Hills Girls Technology High School,15320,4,0,4
2517,2013,East Hills Girls Technology High School,15350,10,0,10
2518,2013,East Hills Girls Technology High School,15200,1,0,1
2519,2013,East Hills Girls Technology High School,15160,4,0,4
2520,2013,East Hills Girls Technology High School,15940,1,0,1
2521,2013,East Hills Girls Technology High School,15560,1,0,1
2522,2013,East Hills Girls Technology High School,15030,3,0,3
2523,2013,East Hills Girls Technology High School,15040,5,0,5
2524,2013,East Hills Girls Technology High School,15180,2,0,2
2525,2013,East Hills Girls Technology High School,15060,6,0,6
2526,2013,East Hills Girls Technology High School,15140,4,0,4
2527,2013,East Hills Girls Technology High School,15210,1,0,1
2528,2013,East Hills Girls Technology High School,15250,2,0,2
2529,2013,East Hills Girls Technology High School,15220,3,0,3
2530,2013,East Hills Girls Technology High School,15020,1,0,1
2531,2013,"Amity College, Prestons",15240,13,6,7
2532,2013,"Amity College, Prestons",15270,1,1,0
2533,2013,"Amity College, Prestons",15340,4,4,0
2534,2013,"Amity College, Prestons",15170,1,0,1
2535,2013,"Amity College, Prestons",15230,3,1,2
2536,2013,"Amity College, Prestons",15380,1,0,1
2537,2013,"Amity College, Prestons",15160,2,1,1
2538,2013,"Amity College, Prestons",15260,5,3,2
2539,2013,"Amity College, Prestons",15030,7,1,6
2540,2013,"Amity College, Prestons",15330,2,1,1
2541,2013,"Amity College, Prestons",15140,6,1,5
2542,2013,"Amity College, Prestons",15130,1,0,1
2543,2013,"Amity College, Prestons",15050,7,4,3
2544,2013,"Amity College, Prestons",15250,6,3,3
2545,2013,"Amity College, Prestons",16120,3,1,2
2546,2013,"Amity College, Prestons",15220,7,2,5
2547,2013,Port Macquarie High School,15320,2,1,1
2548,2013,Port Macquarie High School,15160,1,0,1
2549,2013,Port Macquarie High School,15030,2,0,2
2550,2013,Port Macquarie High School,15310,1,1,0
2551,2013,Port Macquarie High School,15400,1,0,1
2552,2013,Port Macquarie High School,15040,1,1,0
2553,2013,Port Macquarie High School,15140,1,0,1
2554,2013,Port Macquarie High School,15020,2,0,2
2555,2013,Port Macquarie High School,15390,1,0,1
2556,2013,Winmalee High School,15240,3,0,3
2557,2013,Winmalee High School,15270,2,0,2
2558,2013,Winmalee High School,15340,1,0,1
2559,2013,Winmalee High School,15170,1,0,1
2560,2013,Winmalee High School,15230,1,1,0
2561,2013,Winmalee High School,15080,1,0,1
2562,2013,Winmalee High School,15120,2,2,0
2563,2013,Winmalee High School,15070,1,0,1
2564,2013,Winmalee High School,15090,3,1,2
2565,2013,Winmalee High School,15320,1,0,1
2566,2013,Winmalee High School,15200,1,1,0
2567,2013,Winmalee High School,15310,1,1,0
2568,2013,Winmalee High School,15400,3,1,2
2569,2013,Winmalee High School,15180,1,0,1
2570,2013,Winmalee High School,15210,1,0,1
2571,2013,Winmalee High School,15290,5,3,2
2572,2013,Winmalee High School,15250,1,0,1
2573,2013,Winmalee High School,15220,2,0,2
2574,2013,Winmalee High School,15020,4,0,4
2575,2013,Cherrybrook Technology High School,15240,42,21,21
2576,2013,Cherrybrook Technology High School,15270,9,5,4
2577,2013,Cherrybrook Technology High School,15340,12,4,8
2578,2013,Cherrybrook Technology High School,15170,2,0,2
2579,2013,Cherrybrook Technology High School,15230,6,3,3
2580,2013,Cherrybrook Technology High School,15190,1,0,1
2581,2013,Cherrybrook Technology High School,15080,2,1,1
2582,2013,Cherrybrook Technology High School,15830,4,0,4
2583,2013,Cherrybrook Technology High School,15120,3,3,0
2584,2013,Cherrybrook Technology High School,15070,1,0,1
2585,2013,Cherrybrook Technology High School,15360,1,1,0
2586,2013,Cherrybrook Technology High School,15850,4,0,4
2587,2013,Cherrybrook Technology High School,15320,6,1,5
2588,2013,Cherrybrook Technology High School,15280,5,3,2
2589,2013,Cherrybrook Technology High School,15350,3,0,3
2590,2013,Cherrybrook Technology High School,15200,5,3,2
2591,2013,Cherrybrook Technology High School,15160,11,3,8
2592,2013,Cherrybrook Technology High School,15300,1,0,1
2593,2013,Cherrybrook Technology High School,15110,5,4,1
2594,2013,Cherrybrook Technology High School,15710,1,0,1
2595,2013,Cherrybrook Technology High School,15680,2,0,2
2596,2013,Cherrybrook Technology High School,15260,6,4,2
2597,2013,Cherrybrook Technology High School,15030,15,5,10
2598,2013,Cherrybrook Technology High School,15310,2,0,2
2599,2013,Cherrybrook Technology High School,26599,2,0,2
2600,2013,Cherrybrook Technology High School,27299,2,2,0
2601,2013,Cherrybrook Technology High School,15330,6,2,4
2602,2013,Cherrybrook Technology High School,15150,3,1,2
2603,2013,Cherrybrook Technology High School,15400,6,1,5
2604,2013,Cherrybrook Technology High School,15100,2,1,1
2605,2013,Cherrybrook Technology High School,15555,1,1,0
2606,2013,Cherrybrook Technology High School,15040,19,11,8
2607,2013,Cherrybrook Technology High School,15180,4,0,4
2608,2013,Cherrybrook Technology High School,15060,2,0,2
2609,2013,Cherrybrook Technology High School,15140,51,16,35
2610,2013,Cherrybrook Technology High School,15050,18,11,7
2611,2013,Cherrybrook Technology High School,15210,1,0,1
2612,2013,Cherrybrook Technology High School,15290,4,2,2
2613,2013,Cherrybrook Technology High School,15250,22,11,11
2614,2013,Cherrybrook Technology High School,15690,2,0,2
2615,2013,Cherrybrook Technology High School,15220,12,5,7
2616,2013,Cherrybrook Technology High School,15020,9,4,5
2617,2013,Cherrybrook Technology High School,15390,1,0,1
2618,2013,Deniliquin High School,15240,1,0,1
2619,2013,Deniliquin High School,15340,3,1,2
2620,2013,Deniliquin High School,15030,1,0,1
2621,2013,The Jannali High School,15340,1,0,1
2622,2013,The Jannali High School,15230,2,1,1
2623,2013,The Jannali High School,15350,4,1,3
2624,2013,The Jannali High School,15030,1,0,1
2625,2013,The Jannali High School,15400,2,1,1
2626,2013,The Jannali High School,15180,1,0,1
2627,2013,The Jannali High School,15020,2,0,2
2628,2013,The Jannali High School,15390,2,1,1
2629,2013,St Clare's College,15240,1,0,1
2630,2013,St Clare's College,15230,1,0,1
2631,2013,St Clare's College,15190,1,0,1
2632,2013,St Clare's College,15080,3,0,3
2633,2013,St Clare's College,15320,3,0,3
2634,2013,St Clare's College,15380,7,0,7
2635,2013,St Clare's College,15680,1,0,1
2636,2013,St Clare's College,15370,3,0,3
2637,2013,St Clare's College,15400,5,0,5
2638,2013,St Clare's College,15040,3,0,3
2639,2013,St Clare's College,15140,2,0,2
2640,2013,St Clare's College,15220,1,0,1
2641,2013,St Clare's College,15020,2,0,2
2642,2013,Mater Maria Catholic College,15240,1,1,0
2643,2013,Mater Maria Catholic College,15270,2,0,2
2644,2013,Mater Maria Catholic College,15170,1,0,1
2645,2013,Mater Maria Catholic College,15230,2,1,1
2646,2013,Mater Maria Catholic College,15080,1,0,1
2647,2013,Mater Maria Catholic College,15830,1,0,1
2648,2013,Mater Maria Catholic College,15090,6,1,5
2649,2013,Mater Maria Catholic College,15200,5,4,1
2650,2013,Mater Maria Catholic College,15380,1,0,1
2651,2013,Mater Maria Catholic College,15160,7,2,5
2652,2013,Mater Maria Catholic College,15300,1,0,1
2653,2013,Mater Maria Catholic College,26699,1,1,0
2654,2013,Mater Maria Catholic College,15370,5,1,4
2655,2013,Mater Maria Catholic College,15330,1,1,0
2656,2013,Mater Maria Catholic College,15400,6,2,4
2657,2013,Mater Maria Catholic College,26199,2,0,2
2658,2013,Mater Maria Catholic College,15140,10,2,8
2659,2013,Mater Maria Catholic College,15050,1,1,0
2660,2013,Mater Maria Catholic College,15290,6,2,4
2661,2013,Mater Maria Catholic College,15250,2,2,0
2662,2013,Mater Maria Catholic College,15020,1,0,1
2663,2013,Mater Maria Catholic College,15390,2,0,2
2664,2013,The Forest High School,15240,6,5,1
2665,2013,The Forest High School,15270,2,1,1
2666,2013,The Forest High School,15230,3,0,3
2667,2013,The Forest High School,15890,1,0,1
2668,2013,The Forest High School,15320,3,1,2
2669,2013,The Forest High School,15280,1,0,1
2670,2013,The Forest High School,15400,1,0,1
2671,2013,The Forest High School,15040,1,0,1
2672,2013,The Forest High School,15180,1,0,1
2673,2013,The Forest High School,15060,2,0,2
2674,2013,The Forest High School,15140,4,2,2
2675,2013,The Forest High School,15290,2,1,1
2676,2013,The Forest High School,15250,2,2,0
2677,2013,St Joseph's Regional College,15240,4,3,1
2678,2013,St Joseph's Regional College,15230,2,2,0
2679,2013,St Joseph's Regional College,15080,1,0,1
2680,2013,St Joseph's Regional College,15090,1,0,1
2681,2013,St Joseph's Regional College,15320,1,1,0
2682,2013,St Joseph's Regional College,15200,3,3,0
2683,2013,St Joseph's Regional College,15380,1,0,1
2684,2013,St Joseph's Regional College,15370,3,0,3
2685,2013,St Joseph's Regional College,26599,1,0,1
2686,2013,St Joseph's Regional College,15400,1,1,0
2687,2013,St Joseph's Regional College,15040,1,1,0
2688,2013,St Joseph's Regional College,15180,2,0,2
2689,2013,St Joseph's Regional College,15130,1,0,1
2690,2013,St Joseph's Regional College,15290,4,2,2
2691,2013,St Joseph's Regional College,15250,2,1,1
2692,2013,St Joseph's Regional College,15020,1,0,1
2693,2013,Lumen Christi Catholic College,15270,1,0,1
2694,2013,Lumen Christi Catholic College,15170,1,0,1
2695,2013,Lumen Christi Catholic College,15190,1,0,1
2696,2013,Lumen Christi Catholic College,15090,3,0,3
2697,2013,Lumen Christi Catholic College,15320,1,0,1
2698,2013,Lumen Christi Catholic College,15280,2,0,2
2699,2013,Lumen Christi Catholic College,15370,6,2,4
2700,2013,Lumen Christi Catholic College,15790,1,0,1
2701,2013,Lumen Christi Catholic College,15310,1,0,1
2702,2013,Lumen Christi Catholic College,15400,1,0,1
2703,2013,Lumen Christi Catholic College,15040,1,0,1
2704,2013,Lumen Christi Catholic College,15750,1,1,0
2705,2013,Lumen Christi Catholic College,15140,5,0,5
2706,2013,Lumen Christi Catholic College,15290,2,0,2
2707,2013,Lumen Christi Catholic College,15250,1,0,1
2708,2013,Lumen Christi Catholic College,15220,1,0,1
2709,2013,Lumen Christi Catholic College,15020,4,1,3
2710,2013,Parkes High School,15320,3,1,2
2711,2013,Parkes High School,15290,1,1,0
2712,2013,Georges River Grammar,15240,1,1,0
2713,2013,Georges River Grammar,15270,3,1,2
2714,2013,Georges River Grammar,15340,1,0,1
2715,2013,Georges River Grammar,15170,1,0,1
2716,2013,Georges River Grammar,15230,8,3,5
2717,2013,Georges River Grammar,15080,2,0,2
2718,2013,Georges River Grammar,15350,2,0,2
2719,2013,Georges River Grammar,15160,1,0,1
2720,2013,Georges River Grammar,26699,1,1,0
2721,2013,Georges River Grammar,16020,2,2,0
2722,2013,Georges River Grammar,15400,1,0,1
2723,2013,Georges River Grammar,15140,3,1,2
2724,2013,Georges River Grammar,15290,3,1,2
2725,2013,Georges River Grammar,15250,2,1,1
2726,2013,Blayney High School,26599,1,0,1
2727,2013,Blayney High School,15290,1,1,0
2728,2013,Bossley Park High School,15240,7,5,2
2729,2013,Bossley Park High School,15270,4,3,1
2730,2013,Bossley Park High School,15230,4,2,2
2731,2013,Bossley Park High School,15070,1,0,1
2732,2013,Bossley Park High School,15090,1,0,1
2733,2013,Bossley Park High School,15350,2,1,1
2734,2013,Bossley Park High School,15380,3,1,2
2735,2013,Bossley Park High School,15110,2,2,0
2736,2013,Bossley Park High School,15260,1,1,0
2737,2013,Bossley Park High School,15030,1,1,0
2738,2013,Bossley Park High School,15510,1,1,0
2739,2013,Bossley Park High School,15400,2,0,2
2740,2013,Bossley Park High School,15040,3,3,0
2741,2013,Bossley Park High School,26199,1,0,1
2742,2013,Bossley Park High School,15180,3,2,1
2743,2013,Bossley Park High School,15060,1,0,1
2744,2013,Bossley Park High School,15140,5,3,2
2745,2013,Bossley Park High School,15050,1,1,0
2746,2013,Bossley Park High School,15290,3,1,2
2747,2013,Bossley Park High School,15250,3,2,1
2748,2013,Bossley Park High School,15020,4,2,2
2749,2013,Coonabarabran High School,15120,4,4,0
2750,2013,Coonabarabran High School,15220,2,0,2
2751,2013,Queenwood School for Girls,15240,3,0,3
2752,2013,Queenwood School for Girls,15270,6,0,6
2753,2013,Queenwood School for Girls,15170,3,1,2
2754,2013,Queenwood School for Girls,15230,10,0,10
2755,2013,Queenwood School for Girls,15190,4,0,4
2756,2013,Queenwood School for Girls,15090,5,1,4
2757,2013,Queenwood School for Girls,15320,2,1,1
2758,2013,Queenwood School for Girls,15280,5,0,5
2759,2013,Queenwood School for Girls,15160,8,1,7
2760,2013,Queenwood School for Girls,15110,4,0,4
2761,2013,Queenwood School for Girls,15710,1,0,1
2762,2013,Queenwood School for Girls,15680,7,0,7
2763,2013,Queenwood School for Girls,15260,1,0,1
2764,2013,Queenwood School for Girls,15030,8,0,8
2765,2013,Queenwood School for Girls,15790,7,0,7
2766,2013,Queenwood School for Girls,15400,12,0,12
2767,2013,Queenwood School for Girls,15040,3,0,3
2768,2013,Queenwood School for Girls,15140,18,1,17
2769,2013,Queenwood School for Girls,15130,2,0,2
2770,2013,Queenwood School for Girls,15290,4,0,4
2771,2013,Queenwood School for Girls,15250,1,0,1
2772,2013,Queenwood School for Girls,15690,3,0,3
2773,2013,Queenwood School for Girls,15020,4,1,3
2774,2013,Inverell High School,15170,1,0,1
2775,2013,Inverell High School,15230,1,0,1
2776,2013,Inverell High School,15280,3,0,3
2777,2013,Inverell High School,15670,1,1,0
2778,2013,Inverell High School,15200,1,1,0
2779,2013,Inverell High School,15160,1,0,1
2780,2013,Inverell High School,15030,1,1,0
2781,2013,Inverell High School,15060,1,0,1
2782,2013,Trundle Central School,15200,1,1,0
2783,2013,Summerland Christian College,15290,1,0,1
2784,2013,Wollemi College,15210,1,1,0
2785,2013,Wollemi College,15250,1,1,0
2786,2013,Maclean High School,15240,1,1,0
2787,2013,Maclean High School,15270,1,0,1
2788,2013,Maclean High School,15320,1,0,1
2789,2013,Maclean High School,26599,1,0,1
2790,2013,Maclean High School,15040,3,1,2
2791,2013,Maclean High School,15290,1,1,0
2792,2013,Maclean High School,15250,1,1,0
2793,2013,Maclean High School,15220,2,1,1
2794,2013,"Illawarra Christian School, Tongarra Campus",15240,3,1,2
2795,2013,"Illawarra Christian School, Tongarra Campus",15270,2,0,2
2796,2013,"Illawarra Christian School, Tongarra Campus",15280,1,1,0
2797,2013,"Illawarra Christian School, Tongarra Campus",15030,2,0,2
2798,2013,"Illawarra Christian School, Tongarra Campus",15050,1,0,1
2799,2013,"Illawarra Christian School, Tongarra Campus",15290,3,2,1
2800,2013,"Illawarra Christian School, Tongarra Campus",15250,2,1,1
2801,2013,James Busby High School,15230,1,0,1
2802,2013,James Busby High School,26599,1,0,1
2803,2013,James Busby High School,15040,1,0,1
2804,2013,James Busby High School,15140,1,0,1
2805,2013,James Busby High School,15050,1,1,0
2806,2013,PLC Armidale,15240,2,0,2
2807,2013,PLC Armidale,15270,2,0,2
2808,2013,PLC Armidale,15170,2,0,2
2809,2013,PLC Armidale,15230,5,0,5
2810,2013,PLC Armidale,15080,2,0,2
2811,2013,PLC Armidale,15090,3,0,3
2812,2013,PLC Armidale,15320,1,0,1
2813,2013,PLC Armidale,15280,1,0,1
2814,2013,PLC Armidale,15160,1,0,1
2815,2013,PLC Armidale,15300,2,0,2
2816,2013,PLC Armidale,15030,2,0,2
2817,2013,PLC Armidale,15310,3,0,3
2818,2013,PLC Armidale,15400,2,0,2
2819,2013,PLC Armidale,15040,1,0,1
2820,2013,PLC Armidale,15020,1,0,1
2821,2013,Beverly Hills Girls High School,15240,2,0,2
2822,2013,Beverly Hills Girls High School,15270,1,0,1
2823,2013,Beverly Hills Girls High School,15230,2,0,2
2824,2013,Beverly Hills Girls High School,15890,1,0,1
2825,2013,Beverly Hills Girls High School,15550,1,0,1
2826,2013,Beverly Hills Girls High School,15280,1,0,1
2827,2013,Beverly Hills Girls High School,15670,1,0,1
2828,2013,Beverly Hills Girls High School,15350,2,0,2
2829,2013,Beverly Hills Girls High School,15160,1,0,1
2830,2013,Beverly Hills Girls High School,15110,2,0,2
2831,2013,Beverly Hills Girls High School,15560,2,0,2
2832,2013,Beverly Hills Girls High School,15570,1,0,1
2833,2013,Beverly Hills Girls High School,15780,1,0,1
2834,2013,Beverly Hills Girls High School,15030,2,0,2
2835,2013,Beverly Hills Girls High School,27299,2,0,2
2836,2013,Beverly Hills Girls High School,15760,1,0,1
2837,2013,Beverly Hills Girls High School,15555,2,0,2
2838,2013,Beverly Hills Girls High School,15040,2,0,2
2839,2013,Beverly Hills Girls High School,15060,2,0,2
2840,2013,Beverly Hills Girls High School,15140,4,1,3
2841,2013,Beverly Hills Girls High School,15130,1,0,1
2842,2013,Beverly Hills Girls High School,15050,1,0,1
2843,2013,Beverly Hills Girls High School,15290,2,0,2
2844,2013,Beverly Hills Girls High School,15250,3,0,3
2845,2013,Beverly Hills Girls High School,15220,1,0,1
2846,2013,Beverly Hills Girls High School,15020,1,0,1
2847,2013,Beverly Hills Girls High School,15390,1,0,1
2848,2013,Charlton Christian College,15240,1,1,0
2849,2013,Charlton Christian College,15080,1,0,1
2850,2013,Charlton Christian College,15120,1,1,0
2851,2013,Charlton Christian College,15060,2,0,2
2852,2013,Charlton Christian College,15220,2,1,1
2853,2013,Norfolk Island Central School,15360,1,1,0
2854,2013,Plumpton High School,15660,1,0,1
2855,2013,Plumpton High School,15160,1,0,1
2856,2013,Plumpton High School,15250,1,1,0
2857,2013,South Grafton High School,15240,3,1,2
2858,2013,South Grafton High School,15170,2,0,2
2859,2013,South Grafton High School,15120,1,1,0
2860,2013,South Grafton High School,15670,2,0,2
2861,2013,South Grafton High School,15200,1,0,1
2862,2013,South Grafton High School,15160,1,0,1
2863,2013,South Grafton High School,15110,1,0,1
2864,2013,South Grafton High School,15400,1,0,1
2865,2013,South Grafton High School,15140,1,0,1
2866,2013,South Grafton High School,15220,1,0,1
2867,2013,Magdalene Catholic High School,15240,2,2,0
2868,2013,Magdalene Catholic High School,15230,4,4,0
2869,2013,Magdalene Catholic High School,15080,4,3,1
2870,2013,Magdalene Catholic High School,15090,1,1,0
2871,2013,Magdalene Catholic High School,15320,4,0,4
2872,2013,Magdalene Catholic High School,15200,4,3,1
2873,2013,Magdalene Catholic High School,15310,1,0,1
2874,2013,Magdalene Catholic High School,26599,3,0,3
2875,2013,Magdalene Catholic High School,15040,1,1,0
2876,2013,Magdalene Catholic High School,15060,4,1,3
2877,2013,Magdalene Catholic High School,15210,2,1,1
2878,2013,Magdalene Catholic High School,15290,5,3,2
2879,2013,Magdalene Catholic High School,15020,1,0,1
2880,2013,Magdalene Catholic High School,15390,1,0,1
2881,2013,Tempe High School,15240,10,5,5
2882,2013,Tempe High School,15270,1,0,1
2883,2013,Tempe High School,15340,5,2,3
2884,2013,Tempe High School,15170,1,0,1
2885,2013,Tempe High School,15230,5,4,1
2886,2013,Tempe High School,15830,1,1,0
2887,2013,Tempe High School,15090,1,1,0
2888,2013,Tempe High School,15850,1,1,0
2889,2013,Tempe High School,15320,2,2,0
2890,2013,Tempe High School,15820,1,0,1
2891,2013,Tempe High School,15110,1,0,1
2892,2013,Tempe High School,15560,1,0,1
2893,2013,Tempe High School,15540,1,1,0
2894,2013,Tempe High School,15260,6,4,2
2895,2013,Tempe High School,16140,1,0,1
2896,2013,Tempe High School,15030,1,0,1
2897,2013,Tempe High School,15310,2,1,1
2898,2013,Tempe High School,15330,2,1,1
2899,2013,Tempe High School,15400,2,0,2
2900,2013,Tempe High School,15555,1,0,1
2901,2013,Tempe High School,15040,5,2,3
2902,2013,Tempe High School,15060,1,0,1
2903,2013,Tempe High School,15140,2,0,2
2904,2013,Tempe High School,15050,4,2,2
2905,2013,Tempe High School,15290,1,0,1
2906,2013,Tempe High School,15250,14,8,6
2907,2013,Tempe High School,15220,3,1,2
2908,2013,Tempe High School,15020,3,2,1
2909,2013,Marian Catholic College,15240,8,6,2
2910,2013,Marian Catholic College,15230,10,2,8
2911,2013,Marian Catholic College,15080,3,0,3
2912,2013,Marian Catholic College,15320,5,2,3
2913,2013,Marian Catholic College,15380,11,2,9
2914,2013,Marian Catholic College,15160,1,0,1
2915,2013,Marian Catholic College,15370,1,0,1
2916,2013,Marian Catholic College,26599,5,0,5
2917,2013,Marian Catholic College,15400,7,1,6
2918,2013,Marian Catholic College,15040,2,1,1
2919,2013,Marian Catholic College,15180,1,0,1
2920,2013,Marian Catholic College,15060,3,1,2
2921,2013,Marian Catholic College,15140,4,0,4
2922,2013,Marian Catholic College,15130,1,1,0
2923,2013,Marian Catholic College,15290,3,2,1
2924,2013,Marian Catholic College,15250,4,3,1
2925,2013,Marian Catholic College,15220,3,1,2
2926,2013,Marian Catholic College,15020,3,0,3
2927,2013,Carlingford High School,15240,15,11,4
2928,2013,Carlingford High School,15270,3,1,2
2929,2013,Carlingford High School,15340,4,0,4
2930,2013,Carlingford High School,15170,3,1,2
2931,2013,Carlingford High School,15230,1,0,1
2932,2013,Carlingford High School,15830,3,2,1
2933,2013,Carlingford High School,16080,1,0,1
2934,2013,Carlingford High School,15850,2,0,2
2935,2013,Carlingford High School,15320,2,0,2
2936,2013,Carlingford High School,15820,4,2,2
2937,2013,Carlingford High School,15160,6,2,4
2938,2013,Carlingford High School,15110,2,1,1
2939,2013,Carlingford High School,16020,1,0,1
2940,2013,Carlingford High School,15260,6,3,3
2941,2013,Carlingford High School,15030,1,0,1
2942,2013,Carlingford High School,15310,4,0,4
2943,2013,Carlingford High School,26599,2,0,2
2944,2013,Carlingford High School,27299,1,0,1
2945,2013,Carlingford High School,15330,3,3,0
2946,2013,Carlingford High School,15150,2,1,1
2947,2013,Carlingford High School,15400,3,1,2
2948,2013,Carlingford High School,15040,6,2,4
2949,2013,Carlingford High School,15180,1,0,1
2950,2013,Carlingford High School,15140,11,3,8
2951,2013,Carlingford High School,15050,3,3,0
2952,2013,Carlingford High School,15290,5,0,5
2953,2013,Carlingford High School,15250,17,11,6
2954,2013,Carlingford High School,15220,1,0,1
2955,2013,Carlingford High School,15020,2,0,2
2956,2013,Warialda High School,15230,1,1,0
2957,2013,Cranbrook School,15240,28,28,0
2958,2013,Cranbrook School,15270,11,11,0
2959,2013,Cranbrook School,15170,1,1,0
2960,2013,Cranbrook School,15230,10,10,0
2961,2013,Cranbrook School,15190,2,2,0
2962,2013,Cranbrook School,15080,3,3,0
2963,2013,Cranbrook School,15090,7,7,0
2964,2013,Cranbrook School,15850,1,1,0
2965,2013,Cranbrook School,15320,3,3,0
2966,2013,Cranbrook School,15280,1,1,0
2967,2013,Cranbrook School,15200,6,6,0
2968,2013,Cranbrook School,15160,5,5,0
2969,2013,Cranbrook School,15300,1,1,0
2970,2013,Cranbrook School,15110,12,12,0
2971,2013,Cranbrook School,15710,1,1,0
2972,2013,Cranbrook School,15680,7,7,0
2973,2013,Cranbrook School,15540,1,1,0
2974,2013,Cranbrook School,15260,3,3,0
2975,2013,Cranbrook School,15030,3,3,0
2976,2013,Cranbrook School,15370,1,1,0
2977,2013,Cranbrook School,15970,1,1,0
2978,2013,Cranbrook School,15330,9,9,0
2979,2013,Cranbrook School,15400,7,6,1
2980,2013,Cranbrook School,15040,7,7,0
2981,2013,Cranbrook School,15800,1,1,0
2982,2013,Cranbrook School,15140,14,14,0
2983,2013,Cranbrook School,15050,8,8,0
2984,2013,Cranbrook School,15290,2,2,0
2985,2013,Cranbrook School,15250,20,19,1
2986,2013,Cranbrook School,15690,1,1,0
2987,2013,Cranbrook School,15220,8,8,0
2988,2013,Cranbrook School,15020,10,10,0
2989,2013,Wiley Park Girls High School,15660,1,0,1
2990,2013,Wiley Park Girls High School,15350,1,0,1
2991,2013,Wiley Park Girls High School,15140,1,0,1
2992,2013,Wiley Park Girls High School,15220,1,0,1
2993,2013,Mary MacKillop Catholic College,15240,2,0,2
2994,2013,Mary MacKillop Catholic College,15340,1,0,1
2995,2013,Mary MacKillop Catholic College,15230,2,0,2
2996,2013,Mary MacKillop Catholic College,15080,1,0,1
2997,2013,Mary MacKillop Catholic College,15070,1,0,1
2998,2013,Mary MacKillop Catholic College,15320,1,0,1
2999,2013,Mary MacKillop Catholic College,15350,3,0,3
3000,2013,Mary MacKillop Catholic College,15160,2,0,2
3001,2013,Mary MacKillop Catholic College,15030,1,0,1
3002,2013,Mary MacKillop Catholic College,15370,4,0,4
3003,2013,Mary MacKillop Catholic College,26599,1,0,1
3004,2013,Mary MacKillop Catholic College,15510,2,0,2
3005,2013,Mary MacKillop Catholic College,15150,2,0,2
3006,2013,Mary MacKillop Catholic College,15040,3,0,3
3007,2013,Mary MacKillop Catholic College,15520,1,0,1
3008,2013,Mary MacKillop Catholic College,15180,1,0,1
3009,2013,Mary MacKillop Catholic College,15060,1,0,1
3010,2013,Mary MacKillop Catholic College,15050,3,0,3
3011,2013,Mary MacKillop Catholic College,15250,3,0,3
3012,2013,Mary MacKillop Catholic College,15220,3,0,3
3013,2013,Fairvale High School,15240,7,4,3
3014,2013,Fairvale High School,26999,1,0,1
3015,2013,Fairvale High School,15230,3,1,2
3016,2013,Fairvale High School,15320,2,0,2
3017,2013,Fairvale High School,15200,4,4,0
3018,2013,Fairvale High School,15160,1,0,1
3019,2013,Fairvale High School,15110,1,0,1
3020,2013,Fairvale High School,15030,1,0,1
3021,2013,Fairvale High School,15150,1,1,0
3022,2013,Fairvale High School,15400,8,1,7
3023,2013,Fairvale High School,15040,2,0,2
3024,2013,Fairvale High School,26199,1,1,0
3025,2013,Fairvale High School,15210,3,3,0
3026,2013,Fairvale High School,15290,1,0,1
3027,2013,Fairvale High School,15250,6,3,3
3028,2013,Fairvale High School,15220,4,0,4
3029,2013,Fairvale High School,15020,4,2,2
3030,2013,Al-Faisal College,15240,6,3,3
3031,2013,Al-Faisal College,15340,2,2,0
3032,2013,Al-Faisal College,15230,2,2,0
3033,2013,Al-Faisal College,15260,1,1,0
3034,2013,Al-Faisal College,15030,2,0,2
3035,2013,Al-Faisal College,15330,1,1,0
3036,2013,Al-Faisal College,15510,2,0,2
3037,2013,Al-Faisal College,15040,3,2,1
3038,2013,Al-Faisal College,15060,2,0,2
3039,2013,Al-Faisal College,15140,3,1,2
3040,2013,Al-Faisal College,15050,3,2,1
3041,2013,Al-Faisal College,15250,1,1,0
3042,2013,Al-Faisal College,15220,1,0,1
3043,2013,Lake Munmorah High School,15320,1,0,1
3044,2013,Lake Munmorah High School,15040,1,1,0
3045,2013,Lake Munmorah High School,15060,1,0,1
3046,2013,Callaghan College Jesmond Campus,15340,2,1,1
3047,2013,Callaghan College Jesmond Campus,15230,2,2,0
3048,2013,Callaghan College Jesmond Campus,15090,3,0,3
3049,2013,Callaghan College Jesmond Campus,15200,1,1,0
3050,2013,Callaghan College Jesmond Campus,15210,1,1,0
3051,2013,Callaghan College Jesmond Campus,15290,3,2,1
3052,2013,St Philip's Christian College - Waratah,15240,1,1,0
3053,2013,St Philip's Christian College - Waratah,15270,2,2,0
3054,2013,St Philip's Christian College - Waratah,15230,9,4,5
3055,2013,St Philip's Christian College - Waratah,15190,1,1,0
3056,2013,St Philip's Christian College - Waratah,15120,1,1,0
3057,2013,St Philip's Christian College - Waratah,15670,1,0,1
3058,2013,St Philip's Christian College - Waratah,26299,1,1,0
3059,2013,St Philip's Christian College - Waratah,15380,2,2,0
3060,2013,St Philip's Christian College - Waratah,15160,2,1,1
3061,2013,St Philip's Christian College - Waratah,15370,3,1,2
3062,2013,St Philip's Christian College - Waratah,26599,1,0,1
3063,2013,St Philip's Christian College - Waratah,15060,3,0,3
3064,2013,St Philip's Christian College - Waratah,15140,1,1,0
3065,2013,St Philip's Christian College - Waratah,15290,1,0,1
3066,2013,St Philip's Christian College - Waratah,15220,1,1,0
3067,2013,St Philip's Christian College - Waratah,15020,2,1,1
3068,2013,MacKillop Senior College,15240,2,2,0
3069,2013,MacKillop Senior College,15270,3,1,2
3070,2013,MacKillop Senior College,15340,1,0,1
3071,2013,MacKillop Senior College,15170,2,1,1
3072,2013,MacKillop Senior College,15230,7,3,4
3073,2013,MacKillop Senior College,15080,3,2,1
3074,2013,MacKillop Senior College,15090,7,0,7
3075,2013,MacKillop Senior College,15320,7,3,4
3076,2013,MacKillop Senior College,15280,2,0,2
3077,2013,MacKillop Senior College,15380,5,0,5
3078,2013,MacKillop Senior College,15160,2,1,1
3079,2013,MacKillop Senior College,15370,6,3,3
3080,2013,MacKillop Senior College,26599,1,0,1
3081,2013,MacKillop Senior College,15330,3,3,0
3082,2013,MacKillop Senior College,15400,3,0,3
3083,2013,MacKillop Senior College,15040,5,0,5
3084,2013,MacKillop Senior College,15140,8,2,6
3085,2013,MacKillop Senior College,15210,6,4,2
3086,2013,MacKillop Senior College,15290,5,1,4
3087,2013,MacKillop Senior College,15250,3,3,0
3088,2013,MacKillop Senior College,15220,6,2,4
3089,2013,MacKillop Senior College,15020,3,1,2
3090,2013,MacKillop Senior College,15390,2,0,2
3091,2013,St Dominic's College,15240,4,4,0
3092,2013,St Dominic's College,15270,1,1,0
3093,2013,St Dominic's College,15080,2,2,0
3094,2013,St Dominic's College,15320,2,2,0
3095,2013,St Dominic's College,15200,1,1,0
3096,2013,St Dominic's College,15260,1,1,0
3097,2013,St Dominic's College,15370,2,2,0
3098,2013,St Dominic's College,15310,1,1,0
3099,2013,St Dominic's College,15400,1,1,0
3100,2013,St Dominic's College,15140,1,1,0
3101,2013,St Dominic's College,15250,2,2,0
3102,2013,St Dominic's College,15020,1,1,0
3103,2013,All Saints Catholic Senior College,15240,4,4,0
3104,2013,All Saints Catholic Senior College,15270,1,1,0
3105,2013,All Saints Catholic Senior College,15340,5,1,4
3106,2013,All Saints Catholic Senior College,15230,4,0,4
3107,2013,All Saints Catholic Senior College,15080,2,0,2
3108,2013,All Saints Catholic Senior College,15120,1,1,0
3109,2013,All Saints Catholic Senior College,15090,6,2,4
3110,2013,All Saints Catholic Senior College,15320,1,0,1
3111,2013,All Saints Catholic Senior College,15280,1,0,1
3112,2013,All Saints Catholic Senior College,15350,4,1,3
3113,2013,All Saints Catholic Senior College,26299,1,1,0
3114,2013,All Saints Catholic Senior College,15380,4,2,2
3115,2013,All Saints Catholic Senior College,15160,4,3,1
3116,2013,All Saints Catholic Senior College,16020,1,0,1
3117,2013,All Saints Catholic Senior College,15030,2,1,1
3118,2013,All Saints Catholic Senior College,15370,7,2,5
3119,2013,All Saints Catholic Senior College,15790,1,0,1
3120,2013,All Saints Catholic Senior College,15150,3,2,1
3121,2013,All Saints Catholic Senior College,15040,1,0,1
3122,2013,All Saints Catholic Senior College,15180,3,1,2
3123,2013,All Saints Catholic Senior College,15060,1,0,1
3124,2013,All Saints Catholic Senior College,15140,8,5,3
3125,2013,All Saints Catholic Senior College,15130,1,0,1
3126,2013,All Saints Catholic Senior College,15290,1,1,0
3127,2013,All Saints Catholic Senior College,15250,4,4,0
3128,2013,All Saints Catholic Senior College,15220,5,4,1
3129,2013,All Saints Catholic Senior College,15020,2,2,0
3130,2013,La Salle Catholic College,15240,1,1,0
3131,2013,La Salle Catholic College,15370,1,1,0
3132,2013,La Salle Catholic College,15040,1,1,0
3133,2013,La Salle Catholic College,15140,1,1,0
3134,2013,La Salle Catholic College,15210,1,1,0
3135,2013,La Salle Catholic College,15250,1,1,0
3136,2013,La Salle Catholic College,15220,1,1,0
3137,2013,La Salle Catholic College,15020,1,1,0
3138,2013,Condobolin High School,15290,1,0,1
3139,2013,Loreto Normanhurst,15240,19,0,19
3140,2013,Loreto Normanhurst,15270,9,1,8
3141,2013,Loreto Normanhurst,15340,22,0,22
3142,2013,Loreto Normanhurst,15170,1,0,1
3143,2013,Loreto Normanhurst,15230,26,1,25
3144,2013,Loreto Normanhurst,15190,3,0,3
3145,2013,Loreto Normanhurst,15080,6,1,5
3146,2013,Loreto Normanhurst,15090,21,0,21
3147,2013,Loreto Normanhurst,15320,6,1,5
3148,2013,Loreto Normanhurst,15280,4,0,4
3149,2013,Loreto Normanhurst,15670,3,1,2
3150,2013,Loreto Normanhurst,15380,14,0,14
3151,2013,Loreto Normanhurst,15160,6,0,6
3152,2013,Loreto Normanhurst,15300,3,0,3
3153,2013,Loreto Normanhurst,15110,1,0,1
3154,2013,Loreto Normanhurst,15680,7,0,7
3155,2013,Loreto Normanhurst,15260,1,0,1
3156,2013,Loreto Normanhurst,15030,9,0,9
3157,2013,Loreto Normanhurst,15370,63,4,59
3158,2013,Loreto Normanhurst,15790,2,0,2
3159,2013,Loreto Normanhurst,15310,1,0,1
3160,2013,Loreto Normanhurst,26599,3,0,3
3161,2013,Loreto Normanhurst,15330,3,0,3
3162,2013,Loreto Normanhurst,15400,20,2,18
3163,2013,Loreto Normanhurst,15040,6,1,5
3164,2013,Loreto Normanhurst,15180,4,0,4
3165,2013,Loreto Normanhurst,15060,7,0,7
3166,2013,Loreto Normanhurst,15140,44,2,42
3167,2013,Loreto Normanhurst,15130,1,0,1
3168,2013,Loreto Normanhurst,15050,3,0,3
3169,2013,Loreto Normanhurst,15290,5,0,5
3170,2013,Loreto Normanhurst,15250,9,0,9
3171,2013,Loreto Normanhurst,15690,2,0,2
3172,2013,Loreto Normanhurst,15220,13,1,12
3173,2013,Loreto Normanhurst,15020,17,0,17
3174,2013,Fairfield High School,15240,2,1,1
3175,2013,Fairfield High School,15270,1,0,1
3176,2013,Fairfield High School,27199,1,1,0
3177,2013,Fairfield High School,15280,3,2,1
3178,2013,Fairfield High School,15160,1,0,1
3179,2013,Fairfield High School,16010,1,1,0
3180,2013,Fairfield High School,15030,1,0,1
3181,2013,Fairfield High School,15510,1,0,1
3182,2013,Fairfield High School,16100,1,0,1
3183,2013,Fairfield High School,15040,1,0,1
3184,2013,Fairfield High School,15520,1,0,1
3185,2013,Fairfield High School,15140,1,0,1
3186,2013,Fairfield High School,15050,2,1,1
3187,2013,Fairfield High School,15210,1,1,0
3188,2013,Fairfield High School,15250,3,2,1
3189,2013,Macquarie College,15240,4,4,0
3190,2013,Macquarie College,15270,2,0,2
3191,2013,Macquarie College,15230,4,3,1
3192,2013,Macquarie College,15190,3,0,3
3193,2013,Macquarie College,15080,1,1,0
3194,2013,Macquarie College,15670,1,0,1
3195,2013,Macquarie College,15160,2,0,2
3196,2013,Macquarie College,15030,1,0,1
3197,2013,Macquarie College,15370,4,0,4
3198,2013,Macquarie College,26599,1,0,1
3199,2013,Macquarie College,15040,1,0,1
3200,2013,Macquarie College,15140,3,0,3
3201,2013,Macquarie College,15290,1,1,0
3202,2013,Macquarie College,15250,1,1,0
3203,2013,Macquarie College,15740,1,0,1
3204,2013,Macquarie College,15220,2,0,2
3205,2013,Nowra Christian School,15170,1,1,0
3206,2013,Nowra Christian School,16080,1,0,1
3207,2013,Nowra Christian School,15200,1,1,0
3208,2013,Nowra Christian School,15140,1,0,1
3209,2013,Sydney Secondary College Blackwattle Bay Campus,15240,26,12,14
3210,2013,Sydney Secondary College Blackwattle Bay Campus,15270,4,2,2
3211,2013,Sydney Secondary College Blackwattle Bay Campus,15340,2,1,1
3212,2013,Sydney Secondary College Blackwattle Bay Campus,15230,3,2,1
3213,2013,Sydney Secondary College Blackwattle Bay Campus,15080,1,1,0
3214,2013,Sydney Secondary College Blackwattle Bay Campus,15830,1,0,1
3215,2013,Sydney Secondary College Blackwattle Bay Campus,15120,3,3,0
3216,2013,Sydney Secondary College Blackwattle Bay Campus,15360,1,1,0
3217,2013,Sydney Secondary College Blackwattle Bay Campus,15090,3,3,0
3218,2013,Sydney Secondary College Blackwattle Bay Campus,15850,1,0,1
3219,2013,Sydney Secondary College Blackwattle Bay Campus,15280,4,3,1
3220,2013,Sydney Secondary College Blackwattle Bay Campus,15350,4,1,3
3221,2013,Sydney Secondary College Blackwattle Bay Campus,15200,1,0,1
3222,2013,Sydney Secondary College Blackwattle Bay Campus,15820,3,2,1
3223,2013,Sydney Secondary College Blackwattle Bay Campus,15160,3,1,2
3224,2013,Sydney Secondary College Blackwattle Bay Campus,15300,1,1,0
3225,2013,Sydney Secondary College Blackwattle Bay Campus,15940,1,0,1
3226,2013,Sydney Secondary College Blackwattle Bay Campus,15110,1,1,0
3227,2013,Sydney Secondary College Blackwattle Bay Campus,15710,1,0,1
3228,2013,Sydney Secondary College Blackwattle Bay Campus,15680,1,0,1
3229,2013,Sydney Secondary College Blackwattle Bay Campus,15540,1,1,0
3230,2013,Sydney Secondary College Blackwattle Bay Campus,15260,2,2,0
3231,2013,Sydney Secondary College Blackwattle Bay Campus,16130,1,0,1
3232,2013,Sydney Secondary College Blackwattle Bay Campus,15030,2,0,2
3233,2013,Sydney Secondary College Blackwattle Bay Campus,15310,1,1,0
3234,2013,Sydney Secondary College Blackwattle Bay Campus,27299,3,1,2
3235,2013,Sydney Secondary College Blackwattle Bay Campus,15330,1,1,0
3236,2013,Sydney Secondary College Blackwattle Bay Campus,15400,3,2,1
3237,2013,Sydney Secondary College Blackwattle Bay Campus,15555,1,0,1
3238,2013,Sydney Secondary College Blackwattle Bay Campus,15040,10,2,8
3239,2013,Sydney Secondary College Blackwattle Bay Campus,15800,2,0,2
3240,2013,Sydney Secondary College Blackwattle Bay Campus,15180,1,0,1
3241,2013,Sydney Secondary College Blackwattle Bay Campus,15140,4,2,2
3242,2013,Sydney Secondary College Blackwattle Bay Campus,15130,1,0,1
3243,2013,Sydney Secondary College Blackwattle Bay Campus,15050,1,0,1
3244,2013,Sydney Secondary College Blackwattle Bay Campus,15290,3,3,0
3245,2013,Sydney Secondary College Blackwattle Bay Campus,15250,17,10,7
3246,2013,Sydney Secondary College Blackwattle Bay Campus,15220,3,1,2
3247,2013,Sydney Secondary College Blackwattle Bay Campus,15020,4,1,3
3248,2013,Elderslie High School,15340,1,0,1
3249,2013,Elderslie High School,15230,1,0,1
3250,2013,Elderslie High School,15200,2,2,0
3251,2013,Elderslie High School,15060,1,0,1
3252,2013,Elderslie High School,15140,2,0,2
3253,2013,Elderslie High School,15220,1,0,1
3254,2013,Elderslie High School,15020,4,1,3
3255,2013,Elderslie High School,15390,1,0,1
3256,2013,Patrician Brothers' College Blacktown,15240,2,2,0
3257,2013,Patrician Brothers' College Blacktown,15270,2,2,0
3258,2013,Patrician Brothers' College Blacktown,15230,1,1,0
3259,2013,Patrician Brothers' College Blacktown,15380,1,1,0
3260,2013,Patrician Brothers' College Blacktown,15160,1,1,0
3261,2013,Patrician Brothers' College Blacktown,15260,1,1,0
3262,2013,Patrician Brothers' College Blacktown,16130,1,1,0
3263,2013,Patrician Brothers' College Blacktown,15030,3,3,0
3264,2013,Patrician Brothers' College Blacktown,15100,2,2,0
3265,2013,Patrician Brothers' College Blacktown,15140,2,2,0
3266,2013,Patrician Brothers' College Blacktown,15050,1,1,0
3267,2013,Patrician Brothers' College Blacktown,15250,1,1,0
3268,2013,Patrician Brothers' College Blacktown,15220,1,1,0
3269,2013,Patrician Brothers' College Blacktown,15020,4,4,0
3270,2013,Sefton High School,15240,39,18,21
3271,2013,Sefton High School,15270,6,2,4
3272,2013,Sefton High School,15170,2,0,2
3273,2013,Sefton High School,15230,9,3,6
3274,2013,Sefton High School,15320,4,1,3
3275,2013,Sefton High School,15280,3,0,3
3276,2013,Sefton High School,15160,5,0,5
3277,2013,Sefton High School,15110,2,1,1
3278,2013,Sefton High School,15560,1,0,1
3279,2013,Sefton High School,26699,1,1,0
3280,2013,Sefton High School,15260,20,14,6
3281,2013,Sefton High School,16010,1,0,1
3282,2013,Sefton High School,15030,10,4,6
3283,2013,Sefton High School,15370,2,1,1
3284,2013,Sefton High School,26599,1,0,1
3285,2013,Sefton High School,15330,16,13,3
3286,2013,Sefton High School,15040,3,0,3
3287,2013,Sefton High School,15885,2,0,2
3288,2013,Sefton High School,15140,28,9,19
3289,2013,Sefton High School,15130,1,0,1
3290,2013,Sefton High School,15050,18,11,7
3291,2013,Sefton High School,15210,4,3,1
3292,2013,Sefton High School,15290,1,0,1
3293,2013,Sefton High School,15250,41,26,15
3294,2013,Sefton High School,15220,6,0,6
3295,2013,Sefton High School,15020,8,2,6
3296,2013,Northern Sydney Institute - North Sydney College,15230,2,2,0
3297,2013,Pennant Hills High School,15270,2,1,1
3298,2013,Pennant Hills High School,15170,1,0,1
3299,2013,Pennant Hills High School,15230,2,0,2
3300,2013,Pennant Hills High School,15120,1,1,0
3301,2013,Pennant Hills High School,15090,2,1,1
3302,2013,Pennant Hills High School,15320,1,0,1
3303,2013,Pennant Hills High School,15350,5,1,4
3304,2013,Pennant Hills High School,15200,14,12,2
3305,2013,Pennant Hills High School,15380,1,0,1
3306,2013,Pennant Hills High School,15300,1,1,0
3307,2013,Pennant Hills High School,15260,1,0,1
3308,2013,Pennant Hills High School,15030,2,1,1
3309,2013,Pennant Hills High School,15310,4,4,0
3310,2013,Pennant Hills High School,26599,2,1,1
3311,2013,Pennant Hills High School,15330,1,1,0
3312,2013,Pennant Hills High School,15400,4,1,3
3313,2013,Pennant Hills High School,15180,6,0,6
3314,2013,Pennant Hills High School,15060,3,0,3
3315,2013,Pennant Hills High School,15140,1,1,0
3316,2013,Pennant Hills High School,15050,1,1,0
3317,2013,Pennant Hills High School,15290,2,1,1
3318,2013,Pennant Hills High School,15250,3,2,1
3319,2013,Pennant Hills High School,15390,2,0,2
3320,2013,Colyton High School,15200,2,2,0
3321,2013,Colyton High School,15210,1,1,0
3322,2013,Rosebank College,15240,5,0,5
3323,2013,Rosebank College,15270,3,0,3
3324,2013,Rosebank College,15230,3,0,3
3325,2013,Rosebank College,15080,1,0,1
3326,2013,Rosebank College,16080,1,0,1
3327,2013,Rosebank College,15380,6,0,6
3328,2013,Rosebank College,16090,1,0,1
3329,2013,Rosebank College,15110,3,0,3
3330,2013,Rosebank College,15370,1,0,1
3331,2013,Rosebank College,26599,1,1,0
3332,2013,Rosebank College,15400,1,0,1
3333,2013,Rosebank College,15040,2,0,2
3334,2013,Rosebank College,15060,3,0,3
3335,2013,Rosebank College,15140,3,0,3
3336,2013,Rosebank College,15130,2,0,2
3337,2013,Rosebank College,15290,2,0,2
3338,2013,Rosebank College,15250,2,0,2
3339,2013,Rosebank College,15220,4,0,4
3340,2013,Rosebank College,15020,1,0,1
3341,2013,Macksville High School,15240,1,1,0
3342,2013,Macksville High School,15340,1,1,0
3343,2013,John Paul College,15240,3,2,1
3344,2013,John Paul College,15340,2,1,1
3345,2013,John Paul College,15170,2,1,1
3346,2013,John Paul College,15230,5,1,4
3347,2013,John Paul College,15280,2,0,2
3348,2013,John Paul College,15200,5,4,1
3349,2013,John Paul College,15380,1,0,1
3350,2013,John Paul College,15160,5,1,4
3351,2013,John Paul College,15370,4,1,3
3352,2013,John Paul College,26599,3,2,1
3353,2013,John Paul College,15330,2,2,0
3354,2013,John Paul College,15040,3,1,2
3355,2013,John Paul College,15060,1,0,1
3356,2013,John Paul College,15140,1,1,0
3357,2013,John Paul College,15050,1,1,0
3358,2013,John Paul College,15250,3,3,0
3359,2013,John Paul College,15220,2,0,2
3360,2013,John Paul College,15020,2,0,2
3361,2013,Elizabeth Macarthur High School,15230,3,2,1
3362,2013,Elizabeth Macarthur High School,15320,1,1,0
3363,2013,Elizabeth Macarthur High School,15180,1,1,0
3364,2013,Elizabeth Macarthur High School,15290,1,1,0
3365,2013,Kinross Wolaroi School,15240,8,2,6
3366,2013,Kinross Wolaroi School,15270,3,1,2
3367,2013,Kinross Wolaroi School,15170,1,0,1
3368,2013,Kinross Wolaroi School,15230,6,5,1
3369,2013,Kinross Wolaroi School,15190,4,2,2
3370,2013,Kinross Wolaroi School,15320,4,3,1
3371,2013,Kinross Wolaroi School,15280,3,0,3
3372,2013,Kinross Wolaroi School,15200,1,1,0
3373,2013,Kinross Wolaroi School,15300,2,0,2
3374,2013,Kinross Wolaroi School,15110,3,3,0
3375,2013,Kinross Wolaroi School,15710,1,0,1
3376,2013,Kinross Wolaroi School,15680,3,1,2
3377,2013,Kinross Wolaroi School,15260,4,1,3
3378,2013,Kinross Wolaroi School,15030,1,0,1
3379,2013,Kinross Wolaroi School,15370,1,0,1
3380,2013,Kinross Wolaroi School,15310,2,0,2
3381,2013,Kinross Wolaroi School,26599,1,0,1
3382,2013,Kinross Wolaroi School,15330,1,0,1
3383,2013,Kinross Wolaroi School,15400,3,0,3
3384,2013,Kinross Wolaroi School,15040,4,2,2
3385,2013,Kinross Wolaroi School,15140,7,2,5
3386,2013,Kinross Wolaroi School,15050,2,0,2
3387,2013,Kinross Wolaroi School,15290,2,1,1
3388,2013,Kinross Wolaroi School,15250,6,2,4
3389,2013,Kinross Wolaroi School,15690,2,0,2
3390,2013,Kinross Wolaroi School,15220,1,0,1
3391,2013,Kinross Wolaroi School,15020,3,2,1
3392,2013,Kinross Wolaroi School,15390,2,0,2
3393,2013,Kinross Wolaroi School,15700,2,1,1
3394,2013,Asquith Boys High School,15170,2,2,0
3395,2013,Asquith Boys High School,15160,2,2,0
3396,2013,Asquith Boys High School,15400,2,2,0
3397,2013,Asquith Boys High School,15290,2,2,0
3398,2013,Delany College,15240,1,1,0
3399,2013,Delany College,15060,2,0,2
3400,2013,Our Lady of The Sacred Heart College,15240,5,0,5
3401,2013,Our Lady of The Sacred Heart College,15270,2,0,2
3402,2013,Our Lady of The Sacred Heart College,15170,1,0,1
3403,2013,Our Lady of The Sacred Heart College,15230,1,0,1
3404,2013,Our Lady of The Sacred Heart College,15320,1,0,1
3405,2013,Our Lady of The Sacred Heart College,15280,2,0,2
3406,2013,Our Lady of The Sacred Heart College,15350,7,1,6
3407,2013,Our Lady of The Sacred Heart College,15380,4,0,4
3408,2013,Our Lady of The Sacred Heart College,15370,13,1,12
3409,2013,Our Lady of The Sacred Heart College,15150,1,0,1
3410,2013,Our Lady of The Sacred Heart College,15400,2,0,2
3411,2013,Our Lady of The Sacred Heart College,15040,2,0,2
3412,2013,Our Lady of The Sacred Heart College,15060,2,0,2
3413,2013,Our Lady of The Sacred Heart College,15140,4,0,4
3414,2013,Our Lady of The Sacred Heart College,15130,1,0,1
3415,2013,Our Lady of The Sacred Heart College,15210,1,0,1
3416,2013,Our Lady of The Sacred Heart College,15290,1,0,1
3417,2013,Our Lady of The Sacred Heart College,15250,1,0,1
3418,2013,Our Lady of The Sacred Heart College,15220,2,0,2
3419,2013,Our Lady of The Sacred Heart College,15020,3,0,3
3420,2013,Karabar High School,15240,3,2,1
3421,2013,Karabar High School,15270,4,1,3
3422,2013,Karabar High School,15070,1,0,1
3423,2013,Karabar High School,15090,1,0,1
3424,2013,Karabar High School,15320,1,0,1
3425,2013,Karabar High School,15670,1,0,1
3426,2013,Karabar High School,15110,1,1,0
3427,2013,Karabar High School,15540,1,0,1
3428,2013,Karabar High School,15040,2,1,1
3429,2013,Karabar High School,15060,2,0,2
3430,2013,Karabar High School,15020,1,1,0
3431,2013,Mountain View Adventist College,15290,1,0,1
3432,2013,Barrenjoey High School,15340,1,1,0
3433,2013,Barrenjoey High School,15170,2,0,2
3434,2013,Barrenjoey High School,15230,2,2,0
3435,2013,Barrenjoey High School,15090,2,0,2
3436,2013,Barrenjoey High School,15320,1,1,0
3437,2013,Barrenjoey High School,15280,1,0,1
3438,2013,Barrenjoey High School,15350,1,1,0
3439,2013,Barrenjoey High School,15160,1,0,1
3440,2013,Barrenjoey High School,15030,2,0,2
3441,2013,Barrenjoey High School,15400,3,1,2
3442,2013,Barrenjoey High School,15180,1,1,0
3443,2013,Barrenjoey High School,15140,6,2,4
3444,2013,Barrenjoey High School,15020,1,0,1
3445,2013,Cessnock High School,15320,1,0,1
3446,2013,Cessnock High School,15290,2,0,2
3447,2013,McCarthy Catholic College,15320,3,2,1
3448,2013,McCarthy Catholic College,15380,1,1,0
3449,2013,McCarthy Catholic College,15300,2,1,1
3450,2013,McCarthy Catholic College,15030,3,1,2
3451,2013,McCarthy Catholic College,15310,2,0,2
3452,2013,McCarthy Catholic College,15050,1,1,0
3453,2013,McCarthy Catholic College,15250,1,1,0
3454,2013,McCarthy Catholic College,15020,1,1,0
3455,2013,McCarthy Catholic College,15010,2,1,1
3456,2013,The Illawarra Grammar School,15240,2,1,1
3457,2013,The Illawarra Grammar School,15270,3,1,2
3458,2013,The Illawarra Grammar School,15170,1,1,0
3459,2013,The Illawarra Grammar School,15230,7,5,2
3460,2013,The Illawarra Grammar School,15190,3,1,2
3461,2013,The Illawarra Grammar School,15070,1,0,1
3462,2013,The Illawarra Grammar School,15280,1,0,1
3463,2013,The Illawarra Grammar School,15200,1,1,0
3464,2013,The Illawarra Grammar School,15110,2,2,0
3465,2013,The Illawarra Grammar School,15030,3,0,3
3466,2013,The Illawarra Grammar School,15310,1,0,1
3467,2013,The Illawarra Grammar School,15760,1,1,0
3468,2013,The Illawarra Grammar School,15400,1,1,0
3469,2013,The Illawarra Grammar School,15100,1,0,1
3470,2013,The Illawarra Grammar School,15040,3,0,3
3471,2013,The Illawarra Grammar School,15140,4,0,4
3472,2013,The Illawarra Grammar School,15050,3,0,3
3473,2013,The Illawarra Grammar School,15290,8,3,5
3474,2013,The Illawarra Grammar School,15220,1,0,1
3475,2013,The Illawarra Grammar School,15020,1,1,0
3476,2013,Bradfield College,15230,2,0,2
3477,2013,Bradfield College,15090,1,0,1
3478,2013,Bradfield College,15350,1,0,1
3479,2013,Bradfield College,16040,1,0,1
3480,2013,Bradfield College,15290,2,0,2
3481,2013,ALESCO Learning Centre,15060,1,0,1
3482,2013,North Sydney Boys High School,15240,49,47,2
3483,2013,North Sydney Boys High School,15270,8,7,1
3484,2013,North Sydney Boys High School,15170,3,3,0
3485,2013,North Sydney Boys High School,15830,4,4,0
3486,2013,North Sydney Boys High School,15120,7,7,0
3487,2013,North Sydney Boys High School,15720,1,1,0
3488,2013,North Sydney Boys High School,15360,4,3,1
3489,2013,North Sydney Boys High School,15850,2,2,0
3490,2013,North Sydney Boys High School,15320,4,4,0
3491,2013,North Sydney Boys High School,15160,30,27,3
3492,2013,North Sydney Boys High School,15300,5,5,0
3493,2013,North Sydney Boys High School,15110,14,12,2
3494,2013,North Sydney Boys High School,15910,3,3,0
3495,2013,North Sydney Boys High School,15710,1,1,0
3496,2013,North Sydney Boys High School,15680,1,1,0
3497,2013,North Sydney Boys High School,15260,57,52,5
3498,2013,North Sydney Boys High School,15780,2,2,0
3499,2013,North Sydney Boys High School,15900,1,1,0
3500,2013,North Sydney Boys High School,15030,10,9,1
3501,2013,North Sydney Boys High School,15310,4,4,0
3502,2013,North Sydney Boys High School,15330,35,33,2
3503,2013,North Sydney Boys High School,15760,2,2,0
3504,2013,North Sydney Boys High School,15400,5,4,1
3505,2013,North Sydney Boys High School,15555,1,1,0
3506,2013,North Sydney Boys High School,15040,11,10,1
3507,2013,North Sydney Boys High School,15140,45,42,3
3508,2013,North Sydney Boys High School,15050,43,40,3
3509,2013,North Sydney Boys High School,15210,27,26,1
3510,2013,North Sydney Boys High School,15290,5,5,0
3511,2013,North Sydney Boys High School,15250,91,83,8
3512,2013,North Sydney Boys High School,15220,7,6,1
3513,2013,North Sydney Boys High School,15020,6,6,0
3514,2013,Glenwood High School,15240,5,3,2
3515,2013,Glenwood High School,15170,1,0,1
3516,2013,Glenwood High School,15230,2,1,1
3517,2013,Glenwood High School,15070,1,0,1
3518,2013,Glenwood High School,15200,1,1,0
3519,2013,Glenwood High School,15110,1,1,0
3520,2013,Glenwood High School,15260,4,2,2
3521,2013,Glenwood High School,16010,1,0,1
3522,2013,Glenwood High School,16040,1,1,0
3523,2013,Glenwood High School,15030,1,0,1
3524,2013,Glenwood High School,26599,1,0,1
3525,2013,Glenwood High School,15330,5,2,3
3526,2013,Glenwood High School,15100,1,0,1
3527,2013,Glenwood High School,15040,6,2,4
3528,2013,Glenwood High School,15180,1,1,0
3529,2013,Glenwood High School,15140,1,0,1
3530,2013,Glenwood High School,15050,3,1,2
3531,2013,Glenwood High School,15210,2,1,1
3532,2013,Glenwood High School,15250,5,3,2
3533,2013,Glenwood High School,15220,5,3,2
3534,2013,Glenwood High School,15020,1,0,1
3535,2013,Belmont High School,15240,1,1,0
3536,2013,Belmont High School,15170,1,0,1
3537,2013,Belmont High School,15320,1,0,1
3538,2013,Belmont High School,15350,1,0,1
3539,2013,Belmont High School,15200,1,1,0
3540,2013,Belmont High School,15290,3,1,2
3541,2013,Belmont High School,15020,1,1,0
3542,2013,Bishop Tyrrell Anglican College,15240,1,0,1
3543,2013,Bishop Tyrrell Anglican College,15090,1,0,1
3544,2013,Bishop Tyrrell Anglican College,15320,3,0,3
3545,2013,Bishop Tyrrell Anglican College,15160,1,0,1
3546,2013,Bishop Tyrrell Anglican College,15260,1,0,1
3547,2013,Bishop Tyrrell Anglican College,15030,1,0,1
3548,2013,Bishop Tyrrell Anglican College,26599,1,1,0
3549,2013,Bishop Tyrrell Anglican College,15400,2,0,2
3550,2013,Bishop Tyrrell Anglican College,15060,5,0,5
3551,2013,Bishop Tyrrell Anglican College,15250,2,0,2
3552,2013,Bishop Tyrrell Anglican College,15220,1,0,1
3553,2013,Penrith High School,15240,27,18,9
3554,2013,Penrith High School,15270,9,4,5
3555,2013,Penrith High School,15170,7,2,5
3556,2013,Penrith High School,15230,2,1,1
3557,2013,Penrith High School,15080,3,1,2
3558,2013,Penrith High School,15120,4,3,1
3559,2013,Penrith High School,15090,3,1,2
3560,2013,Penrith High School,15320,7,3,4
3561,2013,Penrith High School,15280,6,3,3
3562,2013,Penrith High School,15350,10,4,6
3563,2013,Penrith High School,15200,7,6,1
3564,2013,Penrith High School,15160,3,1,2
3565,2013,Penrith High School,15300,1,1,0
3566,2013,Penrith High School,15110,2,0,2
3567,2013,Penrith High School,15260,12,8,4
3568,2013,Penrith High School,15030,4,1,3
3569,2013,Penrith High School,15370,20,10,10
3570,2013,Penrith High School,15790,1,0,1
3571,2013,Penrith High School,15310,1,1,0
3572,2013,Penrith High School,15330,6,4,2
3573,2013,Penrith High School,15400,3,0,3
3574,2013,Penrith High School,15040,10,5,5
3575,2013,Penrith High School,15800,1,0,1
3576,2013,Penrith High School,15180,1,0,1
3577,2013,Penrith High School,15140,29,9,20
3578,2013,Penrith High School,15050,8,4,4
3579,2013,Penrith High School,15290,4,4,0
3580,2013,Penrith High School,15250,30,21,9
3581,2013,Penrith High School,15220,7,1,6
3582,2013,Penrith High School,15020,9,6,3
3583,2013,"De La Salle College, Revesby Heights",15240,2,2,0
3584,2013,"De La Salle College, Revesby Heights",15270,3,3,0
3585,2013,"De La Salle College, Revesby Heights",15340,1,1,0
3586,2013,"De La Salle College, Revesby Heights",15230,4,4,0
3587,2013,"De La Salle College, Revesby Heights",15360,1,1,0
3588,2013,"De La Salle College, Revesby Heights",15320,1,1,0
3589,2013,"De La Salle College, Revesby Heights",15200,1,1,0
3590,2013,"De La Salle College, Revesby Heights",15260,1,0,1
3591,2013,"De La Salle College, Revesby Heights",15040,1,1,0
3592,2013,"De La Salle College, Revesby Heights",15140,1,1,0
3593,2013,"De La Salle College, Revesby Heights",15290,2,2,0
3594,2013,"De La Salle College, Revesby Heights",15250,2,1,1
3595,2013,"De La Salle College, Revesby Heights",15220,6,6,0
3596,2013,Cecil Hills High School,15240,9,5,4
3597,2013,Cecil Hills High School,15340,2,0,2
3598,2013,Cecil Hills High School,15230,2,1,1
3599,2013,Cecil Hills High School,15120,2,2,0
3600,2013,Cecil Hills High School,15320,2,0,2
3601,2013,Cecil Hills High School,15350,2,0,2
3602,2013,Cecil Hills High School,15110,2,2,0
3603,2013,Cecil Hills High School,26599,4,0,4
3604,2013,Cecil Hills High School,15400,1,0,1
3605,2013,Cecil Hills High School,15040,4,2,2
3606,2013,Cecil Hills High School,15060,3,0,3
3607,2013,Cecil Hills High School,15210,1,1,0
3608,2013,Cecil Hills High School,15290,1,1,0
3609,2013,Cecil Hills High School,15250,4,3,1
3610,2013,Cecil Hills High School,15220,4,3,1
3611,2013,Willoughby Girls High School,15240,3,0,3
3612,2013,Willoughby Girls High School,15270,8,0,8
3613,2013,Willoughby Girls High School,15170,4,0,4
3614,2013,Willoughby Girls High School,15230,4,0,4
3615,2013,Willoughby Girls High School,15080,1,0,1
3616,2013,Willoughby Girls High School,15830,2,0,2
3617,2013,Willoughby Girls High School,15850,1,0,1
3618,2013,Willoughby Girls High School,15320,1,0,1
3619,2013,Willoughby Girls High School,15280,1,0,1
3620,2013,Willoughby Girls High School,15350,25,0,25
3621,2013,Willoughby Girls High School,15200,1,0,1
3622,2013,Willoughby Girls High School,15300,2,0,2
3623,2013,Willoughby Girls High School,15110,2,0,2
3624,2013,Willoughby Girls High School,15030,5,0,5
3625,2013,Willoughby Girls High School,15310,2,0,2
3626,2013,Willoughby Girls High School,15400,7,0,7
3627,2013,Willoughby Girls High School,15555,2,0,2
3628,2013,Willoughby Girls High School,15040,1,0,1
3629,2013,Willoughby Girls High School,15060,2,0,2
3630,2013,Willoughby Girls High School,15140,13,0,13
3631,2013,Willoughby Girls High School,15130,3,0,3
3632,2013,Willoughby Girls High School,15050,2,0,2
3633,2013,Willoughby Girls High School,15250,2,0,2
3634,2013,Willoughby Girls High School,15220,11,0,11
3635,2013,Willoughby Girls High School,15020,8,0,8
3636,2013,Wagga Wagga Christian College,15240,3,3,0
3637,2013,Wagga Wagga Christian College,15360,1,1,0
3638,2013,Wagga Wagga Christian College,15040,1,0,1
3639,2013,Leeton High School,15240,1,1,0
3640,2013,Leeton High School,15270,1,1,0
3641,2013,Leeton High School,15230,1,1,0
3642,2013,Leeton High School,15320,1,1,0
3643,2013,Leeton High School,15110,1,1,0
3644,2013,Leeton High School,15030,2,2,0
3645,2013,Leeton High School,15040,1,1,0
3646,2013,Leeton High School,15290,3,2,1
3647,2013,Leeton High School,15020,1,1,0
3648,2013,Carinya Christian School Tamworth,15230,1,0,1
3649,2013,Carinya Christian School Tamworth,15080,1,1,0
3650,2013,Carinya Christian School Tamworth,15320,4,2,2
3651,2013,Carinya Christian School Tamworth,15330,2,2,0
3652,2013,Carinya Christian School Tamworth,15060,1,0,1
3653,2013,Carinya Christian School Tamworth,15050,1,1,0
3654,2013,Carinya Christian School Tamworth,15250,1,1,0
3655,2013,Carinya Christian School Tamworth,15220,1,1,0
3656,2013,Cardiff High School,15340,2,1,1
3657,2013,Cardiff High School,15230,1,1,0
3658,2013,Cardiff High School,15200,2,2,0
3659,2013,Dorrigo High School,15710,1,0,1
3660,2013,Dorrigo High School,26599,1,0,1
3661,2013,St Scholastica's College Glebe Point,15240,4,0,4
3662,2013,St Scholastica's College Glebe Point,15270,1,0,1
3663,2013,St Scholastica's College Glebe Point,15170,3,0,3
3664,2013,St Scholastica's College Glebe Point,15230,2,0,2
3665,2013,St Scholastica's College Glebe Point,15190,5,0,5
3666,2013,St Scholastica's College Glebe Point,15080,2,0,2
3667,2013,St Scholastica's College Glebe Point,15090,1,0,1
3668,2013,St Scholastica's College Glebe Point,15320,2,0,2
3669,2013,St Scholastica's College Glebe Point,15280,1,0,1
3670,2013,St Scholastica's College Glebe Point,15350,2,0,2
3671,2013,St Scholastica's College Glebe Point,15380,4,0,4
3672,2013,St Scholastica's College Glebe Point,15160,6,0,6
3673,2013,St Scholastica's College Glebe Point,15560,2,0,2
3674,2013,St Scholastica's College Glebe Point,15260,1,0,1
3675,2013,St Scholastica's College Glebe Point,15030,3,0,3
3676,2013,St Scholastica's College Glebe Point,15370,14,0,14
3677,2013,St Scholastica's College Glebe Point,15330,1,0,1
3678,2013,St Scholastica's College Glebe Point,15400,4,0,4
3679,2013,St Scholastica's College Glebe Point,15040,4,0,4
3680,2013,St Scholastica's College Glebe Point,15060,2,0,2
3681,2013,St Scholastica's College Glebe Point,15140,13,0,13
3682,2013,St Scholastica's College Glebe Point,15290,1,0,1
3683,2013,St Scholastica's College Glebe Point,15250,2,0,2
3684,2013,St Scholastica's College Glebe Point,15220,2,0,2
3685,2013,St Scholastica's College Glebe Point,15020,1,0,1
3686,2013,Blue Hills College,15240,2,0,2
3687,2013,St Philip's Christian College - Port Stephens,15320,1,0,1
3688,2013,St Philip's Christian College - Port Stephens,15680,1,1,0
3689,2013,St Philip's Christian College - Port Stephens,15290,1,1,0
3690,2013,St Philip's Christian College - Port Stephens,15250,2,2,0
3691,2013,Henry Kendall High School,15240,3,1,2
3692,2013,Henry Kendall High School,15230,1,0,1
3693,2013,Henry Kendall High School,15200,1,1,0
3694,2013,Henry Kendall High School,15820,1,1,0
3695,2013,Henry Kendall High School,15030,2,0,2
3696,2013,Henry Kendall High School,15400,1,0,1
3697,2013,Henry Kendall High School,15130,1,0,1
3698,2013,Henry Kendall High School,15250,1,1,0
3699,2013,Henry Kendall High School,15220,2,1,1
3700,2013,Henry Kendall High School,15020,1,0,1
3701,2013,St Peter's Catholic College,15270,1,0,1
3702,2013,St Peter's Catholic College,15340,2,1,1
3703,2013,St Peter's Catholic College,15230,6,1,5
3704,2013,St Peter's Catholic College,15120,1,1,0
3705,2013,St Peter's Catholic College,15070,4,3,1
3706,2013,St Peter's Catholic College,15090,1,0,1
3707,2013,St Peter's Catholic College,15320,1,0,1
3708,2013,St Peter's Catholic College,15200,1,1,0
3709,2013,St Peter's Catholic College,15030,1,0,1
3710,2013,St Peter's Catholic College,15040,1,0,1
3711,2013,St Peter's Catholic College,15180,1,0,1
3712,2013,St Peter's Catholic College,15210,1,1,0
3713,2013,St Peter's Catholic College,15290,2,2,0
3714,2013,St Peter's Catholic College,15220,2,1,1
3715,2013,Dubbo Christian School,15230,2,1,1
3716,2013,Dubbo Christian School,15290,2,2,0
3717,2013,Arndell Anglican College,15340,2,2,0
3718,2013,Arndell Anglican College,15230,2,0,2
3719,2013,Arndell Anglican College,15200,1,1,0
3720,2013,Arndell Anglican College,15160,2,0,2
3721,2013,Arndell Anglican College,15030,1,0,1
3722,2013,Arndell Anglican College,15400,1,0,1
3723,2013,Arndell Anglican College,15040,2,0,2
3724,2013,Arndell Anglican College,15060,1,0,1
3725,2013,Arndell Anglican College,15220,1,0,1
3726,2013,Arndell Anglican College,15020,2,0,2
3727,2013,Arndell Anglican College,15390,2,0,2
3728,2013,Xavier College,15240,3,1,2
3729,2013,Xavier College,15200,1,1,0
3730,2013,Xavier College,15160,1,0,1
3731,2013,Xavier College,15030,3,0,3
3732,2013,Xavier College,15370,3,1,2
3733,2013,Xavier College,26599,2,0,2
3734,2013,Xavier College,15400,2,0,2
3735,2013,Xavier College,15040,4,1,3
3736,2013,Xavier College,15060,1,0,1
3737,2013,Xavier College,15140,4,0,4
3738,2013,Xavier College,15220,3,0,3
3739,2013,Broughton Anglican College,15240,5,4,1
3740,2013,Broughton Anglican College,15230,1,1,0
3741,2013,Broughton Anglican College,15320,3,2,1
3742,2013,Broughton Anglican College,15280,1,0,1
3743,2013,Broughton Anglican College,15160,4,2,2
3744,2013,Broughton Anglican College,15940,1,1,0
3745,2013,Broughton Anglican College,15110,1,0,1
3746,2013,Broughton Anglican College,15030,2,1,1
3747,2013,Broughton Anglican College,15330,1,0,1
3748,2013,Broughton Anglican College,15140,6,1,5
3749,2013,Broughton Anglican College,15050,2,1,1
3750,2013,Broughton Anglican College,15220,2,1,1
3751,2013,Broughton Anglican College,15020,1,1,0
3752,2013,Liverpool Boys High School,15240,1,1,0
3753,2013,Liverpool Boys High School,15230,1,1,0
3754,2013,Liverpool Boys High School,15220,1,1,0
3755,2013,Alexandria Park Community School,15270,1,0,1
3756,2013,Alexandria Park Community School,15260,1,1,0
3757,2013,Alexandria Park Community School,15050,1,1,0
3758,2013,Alexandria Park Community School,15250,3,2,1
3759,2013,St Andrew's Cathedral School,15240,6,3,3
3760,2013,St Andrew's Cathedral School,15270,8,2,6
3761,2013,St Andrew's Cathedral School,15170,6,2,4
3762,2013,St Andrew's Cathedral School,15230,13,9,4
3763,2013,St Andrew's Cathedral School,15190,2,1,1
3764,2013,St Andrew's Cathedral School,15830,1,1,0
3765,2013,St Andrew's Cathedral School,15090,5,3,2
3766,2013,St Andrew's Cathedral School,15850,1,1,0
3767,2013,St Andrew's Cathedral School,15320,2,1,1
3768,2013,St Andrew's Cathedral School,15280,1,0,1
3769,2013,St Andrew's Cathedral School,15350,7,0,7
3770,2013,St Andrew's Cathedral School,15160,2,0,2
3771,2013,St Andrew's Cathedral School,15300,6,3,3
3772,2013,St Andrew's Cathedral School,15710,2,1,1
3773,2013,St Andrew's Cathedral School,15560,1,0,1
3774,2013,St Andrew's Cathedral School,15680,3,1,2
3775,2013,St Andrew's Cathedral School,15310,8,6,2
3776,2013,St Andrew's Cathedral School,15330,1,1,0
3777,2013,St Andrew's Cathedral School,15400,5,2,3
3778,2013,St Andrew's Cathedral School,15100,2,1,1
3779,2013,St Andrew's Cathedral School,15040,3,1,2
3780,2013,St Andrew's Cathedral School,15140,7,1,6
3781,2013,St Andrew's Cathedral School,15290,1,0,1
3782,2013,St Andrew's Cathedral School,15220,6,2,4
3783,2013,St Andrew's Cathedral School,15020,6,1,5
3784,2013,Girraween High School,15240,14,8,6
3785,2013,Girraween High School,15270,8,5,3
3786,2013,Girraween High School,15340,6,3,3
3787,2013,Girraween High School,15170,2,0,2
3788,2013,Girraween High School,15360,1,1,0
3789,2013,Girraween High School,15090,4,0,4
3790,2013,Girraween High School,15280,1,0,1
3791,2013,Girraween High School,16070,1,0,1
3792,2013,Girraween High School,15160,15,1,14
3793,2013,Girraween High School,15110,2,1,1
3794,2013,Girraween High School,15680,1,0,1
3795,2013,Girraween High School,15260,11,10,1
3796,2013,Girraween High School,15030,8,5,3
3797,2013,Girraween High School,15310,1,1,0
3798,2013,Girraween High School,15330,7,5,2
3799,2013,Girraween High School,15400,2,0,2
3800,2013,Girraween High School,15040,5,3,2
3801,2013,Girraween High School,15140,24,10,14
3802,2013,Girraween High School,15050,23,15,8
3803,2013,Girraween High School,15250,34,24,10
3804,2013,Girraween High School,15220,11,6,5
3805,2013,Girraween High School,15020,2,1,1
3806,2013,Burwood Girls High School,15240,14,2,12
3807,2013,Burwood Girls High School,15270,2,0,2
3808,2013,Burwood Girls High School,15230,3,0,3
3809,2013,Burwood Girls High School,15320,7,0,7
3810,2013,Burwood Girls High School,15670,3,0,3
3811,2013,Burwood Girls High School,15350,8,0,8
3812,2013,Burwood Girls High School,15820,7,1,6
3813,2013,Burwood Girls High School,15300,2,1,1
3814,2013,Burwood Girls High School,15110,2,0,2
3815,2013,Burwood Girls High School,15710,1,0,1
3816,2013,Burwood Girls High School,15560,4,1,3
3817,2013,Burwood Girls High School,15680,3,1,2
3818,2013,Burwood Girls High School,16020,1,0,1
3819,2013,Burwood Girls High School,15260,4,0,4
3820,2013,Burwood Girls High School,15780,1,0,1
3821,2013,Burwood Girls High School,15980,1,1,0
3822,2013,Burwood Girls High School,15030,8,1,7
3823,2013,Burwood Girls High School,15370,2,0,2
3824,2013,Burwood Girls High School,15790,1,0,1
3825,2013,Burwood Girls High School,15310,3,1,2
3826,2013,Burwood Girls High School,15810,1,0,1
3827,2013,Burwood Girls High School,15330,2,0,2
3828,2013,Burwood Girls High School,15760,2,0,2
3829,2013,Burwood Girls High School,15150,2,0,2
3830,2013,Burwood Girls High School,15400,5,0,5
3831,2013,Burwood Girls High School,15555,3,0,3
3832,2013,Burwood Girls High School,15040,1,0,1
3833,2013,Burwood Girls High School,15800,2,0,2
3834,2013,Burwood Girls High School,15180,1,0,1
3835,2013,Burwood Girls High School,15060,2,0,2
3836,2013,Burwood Girls High School,15140,20,1,19
3837,2013,Burwood Girls High School,15130,1,0,1
3838,2013,Burwood Girls High School,15050,3,1,2
3839,2013,Burwood Girls High School,15290,1,0,1
3840,2013,Burwood Girls High School,15250,7,1,6
3841,2013,Burwood Girls High School,15740,1,0,1
3842,2013,Burwood Girls High School,15220,13,1,12
3843,2013,Burwood Girls High School,15020,5,1,4
3844,2013,Burwood Girls High School,15390,2,0,2
3845,2013,St Mary Star of the Sea College,15240,1,0,1
3846,2013,St Mary Star of the Sea College,15270,2,0,2
3847,2013,St Mary Star of the Sea College,15230,6,0,6
3848,2013,St Mary Star of the Sea College,15070,2,0,2
3849,2013,St Mary Star of the Sea College,15350,2,0,2
3850,2013,St Mary Star of the Sea College,15200,2,0,2
3851,2013,St Mary Star of the Sea College,15380,2,0,2
3852,2013,St Mary Star of the Sea College,15160,2,0,2
3853,2013,St Mary Star of the Sea College,15300,2,0,2
3854,2013,St Mary Star of the Sea College,15110,2,0,2
3855,2013,St Mary Star of the Sea College,15030,4,0,4
3856,2013,St Mary Star of the Sea College,15370,7,0,7
3857,2013,St Mary Star of the Sea College,15310,2,0,2
3858,2013,St Mary Star of the Sea College,15330,1,0,1
3859,2013,St Mary Star of the Sea College,15040,3,0,3
3860,2013,St Mary Star of the Sea College,15800,2,0,2
3861,2013,St Mary Star of the Sea College,15180,1,0,1
3862,2013,St Mary Star of the Sea College,15060,1,0,1
3863,2013,St Mary Star of the Sea College,15140,2,0,2
3864,2013,St Mary Star of the Sea College,15050,3,0,3
3865,2013,St Mary Star of the Sea College,15250,2,0,2
3866,2013,St Mary Star of the Sea College,16120,1,0,1
3867,2013,St Mary Star of the Sea College,15220,3,0,3
3868,2013,St Mary Star of the Sea College,15390,1,0,1
3869,2013,Richmond River High School,15240,1,1,0
3870,2013,Richmond River High School,15340,1,0,1
3871,2013,Richmond River High School,15090,1,0,1
3872,2013,Richmond River High School,15280,1,0,1
3873,2013,Richmond River High School,15350,1,0,1
3874,2013,Richmond River High School,15030,1,1,0
3875,2013,Richmond River High School,15060,1,0,1
3876,2013,Richmond River High School,15140,1,0,1
3877,2013,Richmond River High School,15290,2,2,0
3878,2013,Sutherland Shire Christian School,15240,3,2,1
3879,2013,Sutherland Shire Christian School,15230,5,4,1
3880,2013,Sutherland Shire Christian School,15080,1,1,0
3881,2013,Sutherland Shire Christian School,15090,3,1,2
3882,2013,Sutherland Shire Christian School,15320,1,0,1
3883,2013,Sutherland Shire Christian School,15030,3,1,2
3884,2013,Sutherland Shire Christian School,15370,6,1,5
3885,2013,Sutherland Shire Christian School,15330,1,1,0
3886,2013,Sutherland Shire Christian School,15060,2,0,2
3887,2013,Sutherland Shire Christian School,15750,1,1,0
3888,2013,Sutherland Shire Christian School,15140,3,0,3
3889,2013,Sutherland Shire Christian School,15050,2,1,1
3890,2013,Sutherland Shire Christian School,15210,1,1,0
3891,2013,Sutherland Shire Christian School,15250,2,1,1
3892,2013,Sutherland Shire Christian School,15220,3,0,3
3893,2013,Sutherland Shire Christian School,15020,2,1,1
3894,2013,Sutherland Shire Christian School,15390,3,0,3
3895,2013,Wyndham College,15240,1,1,0
3896,2013,Wyndham College,15340,4,1,3
3897,2013,Wyndham College,26999,2,0,2
3898,2013,Wyndham College,15230,2,1,1
3899,2013,Wyndham College,15320,2,0,2
3900,2013,Wyndham College,15350,5,0,5
3901,2013,Wyndham College,15380,1,0,1
3902,2013,Wyndham College,15820,2,0,2
3903,2013,Wyndham College,15160,1,0,1
3904,2013,Wyndham College,15110,2,2,0
3905,2013,Wyndham College,15260,1,1,0
3906,2013,Wyndham College,15030,1,0,1
3907,2013,Wyndham College,15400,4,3,1
3908,2013,Wyndham College,15040,5,3,2
3909,2013,Wyndham College,15180,2,0,2
3910,2013,Wyndham College,15060,6,0,6
3911,2013,Wyndham College,15140,1,1,0
3912,2013,Wyndham College,15730,1,0,1
3913,2013,Wyndham College,15250,1,1,0
3914,2013,Wyndham College,16120,1,0,1
3915,2013,Farrer Memorial Agricultural High School,15340,2,2,0
3916,2013,Farrer Memorial Agricultural High School,15200,3,3,0
3917,2013,Farrer Memorial Agricultural High School,15040,1,1,0
3918,2013,Auburn Girls High School,15060,2,0,2
3919,2013,St Paul's High School,15240,1,1,0
3920,2013,St Paul's High School,15230,3,2,1
3921,2013,St Paul's High School,15090,1,0,1
3922,2013,St Paul's High School,15320,1,1,0
3923,2013,St Paul's High School,15670,2,0,2
3924,2013,St Paul's High School,15380,1,0,1
3925,2013,St Paul's High School,16020,1,0,1
3926,2013,St Paul's High School,15030,1,1,0
3927,2013,St Paul's High School,15370,4,1,3
3928,2013,St Paul's High School,26599,1,0,1
3929,2013,St Paul's High School,15140,1,0,1
3930,2013,Wadalba Community School,15240,1,0,1
3931,2013,Wadalba Community School,15340,1,0,1
3932,2013,Wadalba Community School,15030,1,0,1
3933,2013,Wadalba Community School,15050,1,0,1
3934,2013,Yass High School,26899,1,0,1
3935,2013,Yass High School,15320,2,0,2
3936,2013,Yass High School,15400,1,0,1
3937,2013,Yass High School,15010,2,0,2
3938,2013,Muswellbrook High School,15230,2,0,2
3939,2013,Muswellbrook High School,15160,1,0,1
3940,2013,Muswellbrook High School,15400,3,0,3
3941,2013,Penrith Christian School,15290,1,0,1
3942,2013,Penrith Christian School,15020,1,0,1
3943,2013,Cheltenham Girls High School,15240,4,0,4
3944,2013,Cheltenham Girls High School,15270,3,0,3
3945,2013,Cheltenham Girls High School,15340,7,0,7
3946,2013,Cheltenham Girls High School,15230,13,0,13
3947,2013,Cheltenham Girls High School,15080,1,0,1
3948,2013,Cheltenham Girls High School,15830,2,0,2
3949,2013,Cheltenham Girls High School,15890,1,0,1
3950,2013,Cheltenham Girls High School,15070,1,0,1
3951,2013,Cheltenham Girls High School,15850,3,0,3
3952,2013,Cheltenham Girls High School,15320,4,0,4
3953,2013,Cheltenham Girls High School,15280,1,0,1
3954,2013,Cheltenham Girls High School,15350,6,0,6
3955,2013,Cheltenham Girls High School,15160,4,0,4
3956,2013,Cheltenham Girls High School,15300,3,0,3
3957,2013,Cheltenham Girls High School,15560,2,0,2
3958,2013,Cheltenham Girls High School,16020,1,0,1
3959,2013,Cheltenham Girls High School,15260,1,0,1
3960,2013,Cheltenham Girls High School,15000,14,1,13
3961,2013,Cheltenham Girls High School,15030,7,0,7
3962,2013,Cheltenham Girls High School,15310,1,0,1
3963,2013,Cheltenham Girls High School,26599,1,0,1
3964,2013,Cheltenham Girls High School,27299,1,0,1
3965,2013,Cheltenham Girls High School,15330,2,0,2
3966,2013,Cheltenham Girls High School,15150,1,0,1
3967,2013,Cheltenham Girls High School,15400,10,1,9
3968,2013,Cheltenham Girls High School,15040,5,0,5
3969,2013,Cheltenham Girls High School,15180,5,0,5
3970,2013,Cheltenham Girls High School,15060,5,0,5
3971,2013,Cheltenham Girls High School,15140,8,0,8
3972,2013,Cheltenham Girls High School,15130,2,0,2
3973,2013,Cheltenham Girls High School,15050,7,0,7
3974,2013,Cheltenham Girls High School,15210,4,0,4
3975,2013,Cheltenham Girls High School,15290,1,0,1
3976,2013,Cheltenham Girls High School,15250,11,1,10
3977,2013,Cheltenham Girls High School,15220,7,0,7
3978,2013,Cheltenham Girls High School,15020,4,0,4
3979,2013,Cheltenham Girls High School,15390,7,0,7
3980,2013,Morisset High School,15240,1,0,1
3981,2013,Morisset High School,15340,1,0,1
3982,2013,Morisset High School,15230,1,0,1
3983,2013,Morisset High School,15200,1,0,1
3984,2013,Morisset High School,15060,1,0,1
3985,2013,St Patrick's College,15340,1,0,1
3986,2013,St Patrick's College,15230,2,0,2
3987,2013,St Patrick's College,15320,2,0,2
3988,2013,St Patrick's College,15350,3,0,3
3989,2013,St Patrick's College,15160,2,0,2
3990,2013,St Patrick's College,15030,1,0,1
3991,2013,St Patrick's College,15370,4,0,4
3992,2013,St Patrick's College,15400,1,0,1
3993,2013,St Patrick's College,15060,1,0,1
3994,2013,St Patrick's College,15020,3,0,3
3995,2013,Macquarie Grammar School,15560,1,0,1
3996,2013,Macquarie Grammar School,15540,3,1,2
3997,2013,Macquarie Grammar School,15260,2,1,1
3998,2013,Macquarie Grammar School,15030,1,0,1
3999,2013,Macquarie Grammar School,15250,3,1,2
4000,2013,Killara High School,15240,36,24,12
4001,2013,Killara High School,15270,9,3,6
4002,2013,Killara High School,15340,4,3,1
4003,2013,Killara High School,15230,17,11,6
4004,2013,Killara High School,15830,4,1,3
4005,2013,Killara High School,15120,2,2,0
4006,2013,Killara High School,16000,1,1,0
4007,2013,Killara High School,15360,2,2,0
4008,2013,Killara High School,15850,6,2,4
4009,2013,Killara High School,15320,5,3,2
4010,2013,Killara High School,15350,5,2,3
4011,2013,Killara High School,15200,9,9,0
4012,2013,Killara High School,15820,1,1,0
4013,2013,Killara High School,15160,10,1,9
4014,2013,Killara High School,15110,3,1,2
4015,2013,Killara High School,15710,1,0,1
4016,2013,Killara High School,15560,1,1,0
4017,2013,Killara High School,15540,1,0,1
4018,2013,Killara High School,15840,1,0,1
4019,2013,Killara High School,15260,13,9,4
4020,2013,Killara High School,15000,1,1,0
4021,2013,Killara High School,15030,9,3,6
4022,2013,Killara High School,15370,3,0,3
4023,2013,Killara High School,15310,2,1,1
4024,2013,Killara High School,26599,1,0,1
4025,2013,Killara High School,27299,1,1,0
4026,2013,Killara High School,15330,15,11,4
4027,2013,Killara High School,15150,1,1,0
4028,2013,Killara High School,15400,7,2,5
4029,2013,Killara High School,15040,5,2,3
4030,2013,Killara High School,15180,1,0,1
4031,2013,Killara High School,15140,24,5,19
4032,2013,Killara High School,15050,19,11,8
4033,2013,Killara High School,15290,1,1,0
4034,2013,Killara High School,15250,24,16,8
4035,2013,Killara High School,15220,10,3,7
4036,2013,Killara High School,15020,7,2,5
4037,2013,Killara High School,15390,2,0,2
4038,2013,Central Coast Adventist School,15160,1,0,1
4039,2013,Central Coast Adventist School,15400,1,0,1
4040,2013,Central Coast Adventist School,15050,1,1,0
4041,2013,Central Coast Adventist School,15290,2,2,0
4042,2013,Central Coast Adventist School,15250,1,1,0
4043,2013,Santa Sabina College,15240,6,0,6
4044,2013,Santa Sabina College,15270,3,0,3
4045,2013,Santa Sabina College,26499,1,0,1
4046,2013,Santa Sabina College,15230,5,0,5
4047,2013,Santa Sabina College,15190,1,0,1
4048,2013,Santa Sabina College,15080,8,1,7
4049,2013,Santa Sabina College,15090,1,0,1
4050,2013,Santa Sabina College,15320,2,0,2
4051,2013,Santa Sabina College,15280,3,0,3
4052,2013,Santa Sabina College,15670,4,0,4
4053,2013,Santa Sabina College,15350,3,0,3
4054,2013,Santa Sabina College,15380,5,1,4
4055,2013,Santa Sabina College,15820,1,0,1
4056,2013,Santa Sabina College,15160,1,0,1
4057,2013,Santa Sabina College,15110,2,0,2
4058,2013,Santa Sabina College,15680,4,0,4
4059,2013,Santa Sabina College,15030,2,0,2
4060,2013,Santa Sabina College,15370,18,0,18
4061,2013,Santa Sabina College,15790,1,0,1
4062,2013,Santa Sabina College,15310,1,0,1
4063,2013,Santa Sabina College,15810,5,0,5
4064,2013,Santa Sabina College,15400,7,0,7
4065,2013,Santa Sabina College,15040,3,0,3
4066,2013,Santa Sabina College,15800,5,0,5
4067,2013,Santa Sabina College,15140,21,1,20
4068,2013,Santa Sabina College,15130,2,0,2
4069,2013,Santa Sabina College,15050,2,0,2
4070,2013,Santa Sabina College,15290,2,0,2
4071,2013,Santa Sabina College,15250,4,0,4
4072,2013,Santa Sabina College,15690,3,0,3
4073,2013,Santa Sabina College,15220,3,0,3
4074,2013,Santa Sabina College,15020,2,0,2
4075,2013,Santa Sabina College,15390,3,0,3
4076,2013,Engadine High School,15240,2,2,0
4077,2013,Engadine High School,15270,1,1,0
4078,2013,Engadine High School,15340,2,1,1
4079,2013,Engadine High School,15230,5,1,4
4080,2013,Engadine High School,15120,1,1,0
4081,2013,Engadine High School,15200,1,1,0
4082,2013,Engadine High School,15330,1,1,0
4083,2013,Engadine High School,15130,1,0,1
4084,2013,Engadine High School,15050,1,1,0
4085,2013,Engadine High School,15210,1,1,0
4086,2013,Engadine High School,15290,1,0,1
4087,2013,Engadine High School,15250,1,1,0
4088,2013,Engadine High School,15390,2,0,2
4089,2013,Narara Valley High School,15240,3,0,3
4090,2013,Narara Valley High School,15230,1,0,1
4091,2013,Narara Valley High School,15200,1,1,0
4092,2013,Narara Valley High School,15030,3,0,3
4093,2013,Narara Valley High School,15400,4,0,4
4094,2013,Narara Valley High School,15100,1,0,1
4095,2013,Narara Valley High School,15290,1,0,1
4096,2013,Narara Valley High School,15020,3,0,3
4097,2013,Newtown High School of Performing Arts,15240,3,1,2
4098,2013,Newtown High School of Performing Arts,15270,7,2,5
4099,2013,Newtown High School of Performing Arts,15170,3,2,1
4100,2013,Newtown High School of Performing Arts,15230,7,2,5
4101,2013,Newtown High School of Performing Arts,15190,2,2,0
4102,2013,Newtown High School of Performing Arts,15070,10,0,10
4103,2013,Newtown High School of Performing Arts,15090,14,5,9
4104,2013,Newtown High School of Performing Arts,15320,3,0,3
4105,2013,Newtown High School of Performing Arts,15280,1,0,1
4106,2013,Newtown High School of Performing Arts,15670,3,0,3
4107,2013,Newtown High School of Performing Arts,15160,8,4,4
4108,2013,Newtown High School of Performing Arts,15300,7,4,3
4109,2013,Newtown High School of Performing Arts,15260,1,1,0
4110,2013,Newtown High School of Performing Arts,15030,3,0,3
4111,2013,Newtown High School of Performing Arts,15790,4,1,3
4112,2013,Newtown High School of Performing Arts,15310,9,6,3
4113,2013,Newtown High School of Performing Arts,15330,2,2,0
4114,2013,Newtown High School of Performing Arts,15400,8,3,5
4115,2013,Newtown High School of Performing Arts,15040,3,1,2
4116,2013,Newtown High School of Performing Arts,15800,1,1,0
4117,2013,Newtown High School of Performing Arts,15180,7,1,6
4118,2013,Newtown High School of Performing Arts,15140,10,3,7
4119,2013,Newtown High School of Performing Arts,15130,2,1,1
4120,2013,Newtown High School of Performing Arts,15290,10,3,7
4121,2013,Newtown High School of Performing Arts,15250,4,3,1
4122,2013,Newtown High School of Performing Arts,15220,6,4,2
4123,2013,Newtown High School of Performing Arts,15020,6,2,4
4124,2013,Newtown High School of Performing Arts,15390,3,0,3
4125,2013,Dubbo School of Distance Education,15050,1,0,1
4126,2013,Dubbo School of Distance Education,15220,1,0,1
4127,2013,Hunter School of Performing Arts,15240,1,0,1
4128,2013,Hunter School of Performing Arts,15270,1,0,1
4129,2013,Hunter School of Performing Arts,15190,1,1,0
4130,2013,Hunter School of Performing Arts,15070,3,1,2
4131,2013,Hunter School of Performing Arts,15090,13,3,10
4132,2013,Hunter School of Performing Arts,15320,1,0,1
4133,2013,Hunter School of Performing Arts,15280,1,0,1
4134,2013,Hunter School of Performing Arts,15350,7,1,6
4135,2013,Hunter School of Performing Arts,15380,2,1,1
4136,2013,Hunter School of Performing Arts,15300,2,0,2
4137,2013,Hunter School of Performing Arts,15030,1,1,0
4138,2013,Hunter School of Performing Arts,15370,1,0,1
4139,2013,Hunter School of Performing Arts,15310,5,3,2
4140,2013,Hunter School of Performing Arts,15400,2,0,2
4141,2013,Hunter School of Performing Arts,15140,2,1,1
4142,2013,Hunter School of Performing Arts,15290,10,4,6
4143,2013,Hunter School of Performing Arts,15220,3,2,1
4144,2013,Hunter School of Performing Arts,15020,1,0,1
4145,2013,Hunter School of Performing Arts,15390,1,1,0
4146,2013,Byron Bay High School,15240,6,3,3
4147,2013,Byron Bay High School,15090,2,1,1
4148,2013,Byron Bay High School,15350,1,0,1
4149,2013,Byron Bay High School,15710,2,1,1
4150,2013,Byron Bay High School,15030,2,0,2
4151,2013,Byron Bay High School,15330,2,0,2
4152,2013,Byron Bay High School,15180,1,0,1
4153,2013,Byron Bay High School,15060,3,0,3
4154,2013,Byron Bay High School,15140,5,1,4
4155,2013,Byron Bay High School,15050,2,0,2
4156,2013,Byron Bay High School,15020,2,0,2
4157,2013,Port Hacking High School,15340,6,2,4
4158,2013,Port Hacking High School,15230,3,0,3
4159,2013,Port Hacking High School,15830,1,1,0
4160,2013,Port Hacking High School,15120,1,1,0
4161,2013,Port Hacking High School,15350,1,0,1
4162,2013,Port Hacking High School,15160,1,0,1
4163,2013,Port Hacking High School,15680,1,0,1
4164,2013,Port Hacking High School,16040,1,0,1
4165,2013,Port Hacking High School,15030,1,0,1
4166,2013,Port Hacking High School,15310,1,0,1
4167,2013,Port Hacking High School,15810,1,0,1
4168,2013,Port Hacking High School,26599,3,0,3
4169,2013,Port Hacking High School,15150,2,1,1
4170,2013,Port Hacking High School,15800,1,0,1
4171,2013,Port Hacking High School,15060,1,0,1
4172,2013,Port Hacking High School,15140,1,0,1
4173,2013,Port Hacking High School,15130,1,0,1
4174,2013,Port Hacking High School,15050,1,1,0
4175,2013,Port Hacking High School,15250,2,2,0
4176,2013,Port Hacking High School,15220,1,0,1
4177,2013,Port Hacking High School,15020,1,0,1
4178,2013,Arthur Phillip High School,15240,10,8,2
4179,2013,Arthur Phillip High School,15270,1,1,0
4180,2013,Arthur Phillip High School,15230,2,2,0
4181,2013,Arthur Phillip High School,15200,4,2,2
4182,2013,Arthur Phillip High School,15110,1,1,0
4183,2013,Arthur Phillip High School,15560,2,1,1
4184,2013,Arthur Phillip High School,15260,2,1,1
4185,2013,Arthur Phillip High School,15400,1,0,1
4186,2013,Arthur Phillip High School,26199,1,1,0
4187,2013,Arthur Phillip High School,15210,2,2,0
4188,2013,Arthur Phillip High School,15250,5,4,1
4189,2013,Australian International School Malaysia,15270,1,0,1
4190,2013,Australian International School Malaysia,15110,1,0,1
4191,2013,Australian International School Malaysia,15150,2,1,1
4192,2013,Australian International School Malaysia,15040,2,1,1
4193,2013,Chester Hill High School,15240,3,2,1
4194,2013,Chester Hill High School,15120,1,0,1
4195,2013,Chester Hill High School,15160,2,0,2
4196,2013,Chester Hill High School,15030,2,0,2
4197,2013,Chester Hill High School,15510,1,1,0
4198,2013,Chester Hill High School,15040,1,1,0
4199,2013,Chester Hill High School,15250,1,1,0
4200,2013,Chester Hill High School,15220,2,0,2
4201,2013,Waverley College,15240,10,10,0
4202,2013,Waverley College,15340,1,1,0
4203,2013,Waverley College,15230,8,8,0
4204,2013,Waverley College,15090,3,3,0
4205,2013,Waverley College,15280,2,2,0
4206,2013,Waverley College,15380,1,1,0
4207,2013,Waverley College,15110,1,1,0
4208,2013,Waverley College,15260,2,2,0
4209,2013,Waverley College,15370,3,3,0
4210,2013,Waverley College,15810,1,1,0
4211,2013,Waverley College,15400,2,2,0
4212,2013,Waverley College,15040,3,3,0
4213,2013,Waverley College,15050,3,3,0
4214,2013,Waverley College,15290,3,3,0
4215,2013,Waverley College,15250,3,3,0
4216,2013,Waverley College,15220,2,2,0
4217,2013,Waverley College,15020,3,3,0
4218,2013,Redfield College,15240,3,3,0
4219,2013,Redfield College,15270,3,3,0
4220,2013,Redfield College,15170,2,2,0
4221,2013,Redfield College,15230,2,2,0
4222,2013,Redfield College,15300,1,1,0
4223,2013,Redfield College,15110,1,1,0
4224,2013,Redfield College,15260,1,1,0
4225,2013,Redfield College,15030,3,3,0
4226,2013,Redfield College,15330,2,2,0
4227,2013,Redfield College,15040,2,2,0
4228,2013,Redfield College,15140,1,1,0
4229,2013,Redfield College,15050,2,2,0
4230,2013,Redfield College,15250,2,2,0
4231,2013,Redfield College,15020,4,4,0
4232,2013,Duval High School,15240,3,3,0
4233,2013,Duval High School,15230,1,0,1
4234,2013,Duval High School,15160,2,1,1
4235,2013,Duval High School,15140,2,1,1
4236,2013,Duval High School,15250,2,2,0
4237,2013,Duval High School,15020,3,3,0
4238,2013,Duval High School,15390,1,0,1
4239,2013,Korowal School,15280,1,1,0
4240,2013,Korowal School,15350,2,1,1
4241,2013,Korowal School,15300,1,1,0
4242,2013,Korowal School,15400,2,1,1
4243,2013,Korowal School,15140,1,1,0
4244,2013,Korowal School,15290,5,3,2
4245,2013,Korowal School,15020,1,1,0
4246,2013,St Columba Anglican School,15270,1,0,1
4247,2013,St Columba Anglican School,15170,3,0,3
4248,2013,St Columba Anglican School,15080,1,0,1
4249,2013,St Columba Anglican School,15070,6,1,5
4250,2013,St Columba Anglican School,15360,2,2,0
4251,2013,St Columba Anglican School,15160,2,0,2
4252,2013,St Columba Anglican School,15300,3,1,2
4253,2013,St Columba Anglican School,15030,1,1,0
4254,2013,St Columba Anglican School,15310,1,1,0
4255,2013,St Columba Anglican School,26599,1,0,1
4256,2013,St Columba Anglican School,15400,2,0,2
4257,2013,St Columba Anglican School,15250,1,1,0
4258,2013,Chatham High School,15240,1,1,0
4259,2013,Chatham High School,15020,1,0,1
4260,2013,St Philip's Christian College - Gosford,15270,1,0,1
4261,2013,St Philip's Christian College - Gosford,15320,1,0,1
4262,2013,St Philip's Christian College - Gosford,15280,1,0,1
4263,2013,St Philip's Christian College - Gosford,15160,1,0,1
4264,2013,St Philip's Christian College - Gosford,15040,1,1,0
4265,2013,St Philip's Christian College - Gosford,15140,1,0,1
4266,2013,St Philip's Christian College - Gosford,15220,2,0,2
4267,2013,Forbes High School,26899,1,0,1
4268,2013,Forbes High School,15280,1,0,1
4269,2013,Forbes High School,15160,1,0,1
4270,2013,Heathcote High School,15240,1,0,1
4271,2013,Heathcote High School,15230,2,1,1
4272,2013,Heathcote High School,15320,1,1,0
4273,2013,Heathcote High School,15250,2,2,0
4274,2013,Heathcote High School,15390,2,0,2
4275,2013,St Columba's High School,15240,1,0,1
4276,2013,St Columba's High School,15340,2,1,1
4277,2013,St Columba's High School,15170,1,1,0
4278,2013,St Columba's High School,15230,1,0,1
4279,2013,St Columba's High School,15320,4,1,3
4280,2013,St Columba's High School,15350,4,1,3
4281,2013,St Columba's High School,15200,3,3,0
4282,2013,St Columba's High School,15160,2,0,2
4283,2013,St Columba's High School,15030,1,0,1
4284,2013,St Columba's High School,15370,6,1,5
4285,2013,St Columba's High School,15400,9,1,8
4286,2013,St Columba's High School,15040,1,1,0
4287,2013,St Columba's High School,15050,1,0,1
4288,2013,St Columba's High School,15290,1,0,1
4289,2013,Arden Anglican School,15240,2,1,1
4290,2013,Arden Anglican School,15270,2,1,1
4291,2013,Arden Anglican School,15340,1,0,1
4292,2013,Arden Anglican School,15170,2,1,1
4293,2013,Arden Anglican School,15230,3,2,1
4294,2013,Arden Anglican School,15190,2,2,0
4295,2013,Arden Anglican School,15120,2,2,0
4296,2013,Arden Anglican School,15280,1,0,1
4297,2013,Arden Anglican School,15160,5,3,2
4298,2013,Arden Anglican School,15260,1,1,0
4299,2013,Arden Anglican School,15330,1,1,0
4300,2013,Arden Anglican School,15040,2,1,1
4301,2013,Arden Anglican School,15060,2,0,2
4302,2013,Arden Anglican School,15140,2,1,1
4303,2013,Arden Anglican School,15050,3,2,1
4304,2013,Arden Anglican School,15290,3,3,0
4305,2013,Arden Anglican School,15250,7,6,1
4306,2013,Arden Anglican School,15220,3,2,1
4307,2013,Arden Anglican School,15390,2,0,2
4308,2013,William Branwhite Clarke College,15240,2,1,1
4309,2013,William Branwhite Clarke College,15270,4,0,4
4310,2013,William Branwhite Clarke College,15230,3,1,2
4311,2013,William Branwhite Clarke College,15360,1,1,0
4312,2013,William Branwhite Clarke College,15090,5,0,5
4313,2013,William Branwhite Clarke College,15320,4,1,3
4314,2013,William Branwhite Clarke College,15280,1,0,1
4315,2013,William Branwhite Clarke College,15350,6,0,6
4316,2013,William Branwhite Clarke College,15380,2,0,2
4317,2013,William Branwhite Clarke College,15160,6,0,6
4318,2013,William Branwhite Clarke College,15300,3,2,1
4319,2013,William Branwhite Clarke College,15680,1,0,1
4320,2013,William Branwhite Clarke College,15260,2,1,1
4321,2013,William Branwhite Clarke College,15030,2,0,2
4322,2013,William Branwhite Clarke College,15370,2,0,2
4323,2013,William Branwhite Clarke College,15310,5,4,1
4324,2013,William Branwhite Clarke College,26599,2,0,2
4325,2013,William Branwhite Clarke College,15330,1,0,1
4326,2013,William Branwhite Clarke College,15400,1,0,1
4327,2013,William Branwhite Clarke College,15040,1,0,1
4328,2013,William Branwhite Clarke College,15140,16,2,14
4329,2013,William Branwhite Clarke College,15210,1,1,0
4330,2013,William Branwhite Clarke College,15290,1,1,0
4331,2013,William Branwhite Clarke College,15250,4,2,2
4332,2013,William Branwhite Clarke College,15220,5,1,4
4333,2013,William Branwhite Clarke College,15020,4,0,4
4334,2013,William Branwhite Clarke College,15390,2,0,2
4335,2013,St Mark's Catholic College,15240,4,0,4
4336,2013,St Mark's Catholic College,15320,1,0,1
4337,2013,St Mark's Catholic College,15200,1,1,0
4338,2013,St Mark's Catholic College,15380,2,0,2
4339,2013,St Mark's Catholic College,15160,1,0,1
4340,2013,St Mark's Catholic College,15260,1,1,0
4341,2013,St Mark's Catholic College,15030,3,1,2
4342,2013,St Mark's Catholic College,15370,1,0,1
4343,2013,St Mark's Catholic College,15400,2,0,2
4344,2013,St Mark's Catholic College,15040,1,0,1
4345,2013,St Mark's Catholic College,15140,3,0,3
4346,2013,St Mark's Catholic College,15250,1,1,0
4347,2013,Nyngan High School,15200,1,1,0
4348,2013,Canterbury Girls High School,15240,2,0,2
4349,2013,Canterbury Girls High School,15230,1,0,1
4350,2013,Canterbury Girls High School,15890,1,1,0
4351,2013,Canterbury Girls High School,15090,1,0,1
4352,2013,Canterbury Girls High School,15670,1,0,1
4353,2013,Canterbury Girls High School,15350,3,0,3
4354,2013,Canterbury Girls High School,15140,4,0,4
4355,2013,Canterbury Girls High School,15290,4,1,3
4356,2013,Canterbury Girls High School,15220,3,0,3
4357,2013,St Johns Park High School,15240,9,7,2
4358,2013,St Johns Park High School,15320,1,0,1
4359,2013,St Johns Park High School,15160,1,1,0
4360,2013,St Johns Park High School,15260,2,1,1
4361,2013,St Johns Park High School,15030,2,2,0
4362,2013,St Johns Park High School,26599,1,0,1
4363,2013,St Johns Park High School,15330,1,1,0
4364,2013,St Johns Park High School,15100,1,0,1
4365,2013,St Johns Park High School,15060,2,1,1
4366,2013,St Johns Park High School,15050,1,1,0
4367,2013,St Johns Park High School,15210,2,2,0
4368,2013,St Johns Park High School,15250,8,5,3
4369,2013,St Johns Park High School,15390,1,0,1
4370,2013,Presbyterian Ladies' College Sydney,15240,15,0,15
4371,2013,Presbyterian Ladies' College Sydney,15270,8,0,8
4372,2013,Presbyterian Ladies' College Sydney,15170,3,0,3
4373,2013,Presbyterian Ladies' College Sydney,15230,8,0,8
4374,2013,Presbyterian Ladies' College Sydney,15080,2,1,1
4375,2013,Presbyterian Ladies' College Sydney,15830,1,0,1
4376,2013,Presbyterian Ladies' College Sydney,15090,1,0,1
4377,2013,Presbyterian Ladies' College Sydney,15850,2,0,2
4378,2013,Presbyterian Ladies' College Sydney,15550,1,0,1
4379,2013,Presbyterian Ladies' College Sydney,15320,7,0,7
4380,2013,Presbyterian Ladies' College Sydney,15280,4,0,4
4381,2013,Presbyterian Ladies' College Sydney,15160,12,0,12
4382,2013,Presbyterian Ladies' College Sydney,15300,1,0,1
4383,2013,Presbyterian Ladies' College Sydney,15110,5,0,5
4384,2013,Presbyterian Ladies' College Sydney,15910,1,0,1
4385,2013,Presbyterian Ladies' College Sydney,15560,1,0,1
4386,2013,Presbyterian Ladies' College Sydney,15680,4,0,4
4387,2013,Presbyterian Ladies' College Sydney,15260,4,0,4
4388,2013,Presbyterian Ladies' College Sydney,15980,1,0,1
4389,2013,Presbyterian Ladies' College Sydney,15900,1,0,1
4390,2013,Presbyterian Ladies' College Sydney,15030,3,0,3
4391,2013,Presbyterian Ladies' College Sydney,15370,6,0,6
4392,2013,Presbyterian Ladies' College Sydney,15310,3,0,3
4393,2013,Presbyterian Ladies' College Sydney,15810,2,0,2
4394,2013,Presbyterian Ladies' College Sydney,15400,13,1,12
4395,2013,Presbyterian Ladies' College Sydney,15040,9,1,8
4396,2013,Presbyterian Ladies' College Sydney,15800,2,0,2
4397,2013,Presbyterian Ladies' College Sydney,15180,1,0,1
4398,2013,Presbyterian Ladies' College Sydney,15140,37,0,37
4399,2013,Presbyterian Ladies' College Sydney,15050,6,0,6
4400,2013,Presbyterian Ladies' College Sydney,15290,2,0,2
4401,2013,Presbyterian Ladies' College Sydney,15250,10,0,10
4402,2013,Presbyterian Ladies' College Sydney,15690,2,0,2
4403,2013,Presbyterian Ladies' College Sydney,15220,18,0,18
4404,2013,Presbyterian Ladies' College Sydney,15020,9,0,9
4405,2013,Presbyterian Ladies' College Sydney,15390,3,0,3
4406,2013,"Shearwater, The Mullumbimby Steiner School",15170,1,0,1
4407,2013,"Shearwater, The Mullumbimby Steiner School",16070,1,1,0
4408,2013,"Shearwater, The Mullumbimby Steiner School",15790,1,0,1
4409,2013,Sydney Boys High School,15240,80,70,10
4410,2013,Sydney Boys High School,15270,17,16,1
4411,2013,Sydney Boys High School,15340,6,6,0
4412,2013,Sydney Boys High School,15170,2,2,0
4413,2013,Sydney Boys High School,15190,4,4,0
4414,2013,Sydney Boys High School,15830,1,1,0
4415,2013,Sydney Boys High School,15120,3,3,0
4416,2013,Sydney Boys High School,15360,7,5,2
4417,2013,Sydney Boys High School,15090,1,1,0
4418,2013,Sydney Boys High School,15850,1,1,0
4419,2013,Sydney Boys High School,15550,4,3,1
4420,2013,Sydney Boys High School,15280,1,1,0
4421,2013,Sydney Boys High School,15590,1,1,0
4422,2013,Sydney Boys High School,15380,1,1,0
4423,2013,Sydney Boys High School,15820,3,3,0
4424,2013,Sydney Boys High School,15160,23,21,2
4425,2013,Sydney Boys High School,15300,9,9,0
4426,2013,Sydney Boys High School,15580,1,1,0
4427,2013,Sydney Boys High School,15110,17,15,2
4428,2013,Sydney Boys High School,15710,1,1,0
4429,2013,Sydney Boys High School,15260,57,53,4
4430,2013,Sydney Boys High School,15900,1,1,0
4431,2013,Sydney Boys High School,15030,6,6,0
4432,2013,Sydney Boys High School,15370,2,2,0
4433,2013,Sydney Boys High School,15310,6,6,0
4434,2013,Sydney Boys High School,15330,37,35,2
4435,2013,Sydney Boys High School,15400,1,1,0
4436,2013,Sydney Boys High School,15555,2,2,0
4437,2013,Sydney Boys High School,15040,11,10,1
4438,2013,Sydney Boys High School,15140,51,47,4
4439,2013,Sydney Boys High School,15050,37,34,3
4440,2013,Sydney Boys High School,15290,1,1,0
4441,2013,Sydney Boys High School,15250,91,86,5
4442,2013,Sydney Boys High School,15220,16,16,0
4443,2013,Narrabeen Sports High School,15270,1,0,1
4444,2013,Narrabeen Sports High School,15160,2,0,2
4445,2013,Narrabeen Sports High School,15400,1,0,1
4446,2013,Narrabeen Sports High School,15020,1,0,1
4447,2013,Snowy Mountains Grammar School,15270,1,0,1
4448,2013,Snowy Mountains Grammar School,15230,1,0,1
4449,2013,Snowy Mountains Grammar School,15190,1,1,0
4450,2013,Snowy Mountains Grammar School,15320,1,0,1
4451,2013,Snowy Mountains Grammar School,15160,1,0,1
4452,2013,Snowy Mountains Grammar School,15400,1,0,1
4453,2013,Snowy Mountains Grammar School,15140,1,0,1
4454,2013,Blue Mountains Grammar School,15240,3,3,0
4455,2013,Blue Mountains Grammar School,15270,2,0,2
4456,2013,Blue Mountains Grammar School,15230,3,0,3
4457,2013,Blue Mountains Grammar School,15190,3,2,1
4458,2013,Blue Mountains Grammar School,15080,3,0,3
4459,2013,Blue Mountains Grammar School,15320,4,1,3
4460,2013,Blue Mountains Grammar School,15280,1,0,1
4461,2013,Blue Mountains Grammar School,15380,1,1,0
4462,2013,Blue Mountains Grammar School,15160,2,0,2
4463,2013,Blue Mountains Grammar School,15300,1,0,1
4464,2013,Blue Mountains Grammar School,15560,1,1,0
4465,2013,Blue Mountains Grammar School,15030,4,2,2
4466,2013,Blue Mountains Grammar School,15370,1,0,1
4467,2013,Blue Mountains Grammar School,15310,1,0,1
4468,2013,Blue Mountains Grammar School,15330,1,1,0
4469,2013,Blue Mountains Grammar School,15400,5,1,4
4470,2013,Blue Mountains Grammar School,15040,3,1,2
4471,2013,Blue Mountains Grammar School,15060,2,0,2
4472,2013,Blue Mountains Grammar School,15140,3,0,3
4473,2013,Blue Mountains Grammar School,15050,4,3,1
4474,2013,Blue Mountains Grammar School,15210,1,1,0
4475,2013,Blue Mountains Grammar School,15290,4,2,2
4476,2013,Blue Mountains Grammar School,15250,2,2,0
4477,2013,Blue Mountains Grammar School,15220,1,0,1
4478,2013,Blue Mountains Grammar School,15020,1,0,1
4479,2013,Emanuel School,15240,7,6,1
4480,2013,Emanuel School,15270,3,1,2
4481,2013,Emanuel School,15170,3,1,2
4482,2013,Emanuel School,15230,6,1,5
4483,2013,Emanuel School,16000,2,1,1
4484,2013,Emanuel School,16080,1,0,1
4485,2013,Emanuel School,15360,1,1,0
4486,2013,Emanuel School,15090,6,3,3
4487,2013,Emanuel School,15320,4,1,3
4488,2013,Emanuel School,15280,3,1,2
4489,2013,Emanuel School,15350,4,0,4
4490,2013,Emanuel School,15380,4,0,4
4491,2013,Emanuel School,15160,3,1,2
4492,2013,Emanuel School,15110,3,2,1
4493,2013,Emanuel School,15680,1,0,1
4494,2013,Emanuel School,15260,2,2,0
4495,2013,Emanuel School,15030,6,0,6
4496,2013,Emanuel School,15330,2,2,0
4497,2013,Emanuel School,15400,1,1,0
4498,2013,Emanuel School,15040,6,4,2
4499,2013,Emanuel School,15140,9,6,3
4500,2013,Emanuel School,15050,3,2,1
4501,2013,Emanuel School,15290,5,4,1
4502,2013,Emanuel School,15250,6,5,1
4503,2013,Emanuel School,15220,10,3,7
4504,2013,Emanuel School,15020,2,0,2
4505,2013,Mackillop Catholic College,15240,2,2,0
4506,2013,Mackillop Catholic College,15340,3,2,1
4507,2013,Mackillop Catholic College,15230,7,5,2
4508,2013,Mackillop Catholic College,15380,1,0,1
4509,2013,Mackillop Catholic College,15260,1,1,0
4510,2013,Mackillop Catholic College,15370,4,2,2
4511,2013,Mackillop Catholic College,26599,2,0,2
4512,2013,Mackillop Catholic College,15060,3,0,3
4513,2013,Mackillop Catholic College,15050,1,1,0
4514,2013,Mackillop Catholic College,15250,1,1,0
4515,2013,Mackillop Catholic College,15390,2,0,2
4516,2013,Orara High School,15120,2,2,0
4517,2013,Orara High School,15320,1,0,1
4518,2013,Orara High School,15670,1,1,0
4519,2013,Orara High School,15350,1,0,1
4520,2013,Orara High School,15400,1,0,1
4521,2013,Orara High School,15210,1,1,0
4522,2013,Orara High School,15220,1,0,1
4523,2013,St Narsai Assyrian Christian College,15060,2,0,2
4524,2013,St Narsai Assyrian Christian College,15140,1,0,1
4525,2013,Homebush Boys High School,15240,9,9,0
4526,2013,Homebush Boys High School,15340,1,1,0
4527,2013,Homebush Boys High School,15230,3,3,0
4528,2013,Homebush Boys High School,15830,1,1,0
4529,2013,Homebush Boys High School,27199,1,1,0
4530,2013,Homebush Boys High School,15200,1,1,0
4531,2013,Homebush Boys High School,15820,2,1,1
4532,2013,Homebush Boys High School,15110,1,1,0
4533,2013,Homebush Boys High School,15260,2,2,0
4534,2013,Homebush Boys High School,15030,4,4,0
4535,2013,Homebush Boys High School,26599,1,1,0
4536,2013,Homebush Boys High School,15330,2,2,0
4537,2013,Homebush Boys High School,15400,2,2,0
4538,2013,Homebush Boys High School,15100,1,0,1
4539,2013,Homebush Boys High School,15040,3,3,0
4540,2013,Homebush Boys High School,15140,1,1,0
4541,2013,Homebush Boys High School,15130,1,1,0
4542,2013,Homebush Boys High School,15050,1,1,0
4543,2013,Homebush Boys High School,15210,1,1,0
4544,2013,Homebush Boys High School,15290,1,1,0
4545,2013,Homebush Boys High School,15250,11,10,1
4546,2013,Homebush Boys High School,15220,1,1,0
4547,2013,Homebush Boys High School,15020,2,2,0
4548,2013,Monte Sant' Angelo Mercy College,15240,5,0,5
4549,2013,Monte Sant' Angelo Mercy College,15270,10,0,10
4550,2013,Monte Sant' Angelo Mercy College,15340,2,0,2
4551,2013,Monte Sant' Angelo Mercy College,15170,2,0,2
4552,2013,Monte Sant' Angelo Mercy College,15230,12,0,12
4553,2013,Monte Sant' Angelo Mercy College,15190,7,0,7
4554,2013,Monte Sant' Angelo Mercy College,15080,8,0,8
4555,2013,Monte Sant' Angelo Mercy College,15090,2,0,2
4556,2013,Monte Sant' Angelo Mercy College,15320,6,1,5
4557,2013,Monte Sant' Angelo Mercy College,15350,12,0,12
4558,2013,Monte Sant' Angelo Mercy College,15380,20,0,20
4559,2013,Monte Sant' Angelo Mercy College,15160,6,0,6
4560,2013,Monte Sant' Angelo Mercy College,15300,2,0,2
4561,2013,Monte Sant' Angelo Mercy College,15110,5,0,5
4562,2013,Monte Sant' Angelo Mercy College,15710,1,0,1
4563,2013,Monte Sant' Angelo Mercy College,15680,3,0,3
4564,2013,Monte Sant' Angelo Mercy College,15260,1,0,1
4565,2013,Monte Sant' Angelo Mercy College,15030,2,0,2
4566,2013,Monte Sant' Angelo Mercy College,15370,7,0,7
4567,2013,Monte Sant' Angelo Mercy College,15310,1,0,1
4568,2013,Monte Sant' Angelo Mercy College,15330,4,0,4
4569,2013,Monte Sant' Angelo Mercy College,15400,3,0,3
4570,2013,Monte Sant' Angelo Mercy College,15040,8,0,8
4571,2013,Monte Sant' Angelo Mercy College,15800,1,0,1
4572,2013,Monte Sant' Angelo Mercy College,15060,5,0,5
4573,2013,Monte Sant' Angelo Mercy College,15140,32,0,32
4574,2013,Monte Sant' Angelo Mercy College,15050,4,0,4
4575,2013,Monte Sant' Angelo Mercy College,15250,5,0,5
4576,2013,Monte Sant' Angelo Mercy College,15690,1,0,1
4577,2013,Monte Sant' Angelo Mercy College,15220,13,0,13
4578,2013,Monte Sant' Angelo Mercy College,15020,12,0,12
4579,2013,Gorokan High School,15240,1,1,0
4580,2013,Gorokan High School,15230,1,0,1
4581,2013,Gorokan High School,15350,1,0,1
4582,2013,Gorokan High School,15060,2,0,2
4583,2013,Gorokan High School,15140,1,1,0
4584,2013,Gorokan High School,15250,1,1,0
4585,2013,Gorokan High School,15020,2,1,1
4586,2013,Freeman Catholic College,15240,5,3,2
4587,2013,Freeman Catholic College,15270,4,1,3
4588,2013,Freeman Catholic College,15340,2,1,1
4589,2013,Freeman Catholic College,15230,2,1,1
4590,2013,Freeman Catholic College,15320,1,1,0
4591,2013,Freeman Catholic College,15350,1,0,1
4592,2013,Freeman Catholic College,15200,3,2,1
4593,2013,Freeman Catholic College,15160,6,0,6
4594,2013,Freeman Catholic College,15110,3,2,1
4595,2013,Freeman Catholic College,15260,1,1,0
4596,2013,Freeman Catholic College,15030,2,0,2
4597,2013,Freeman Catholic College,15370,19,7,12
4598,2013,Freeman Catholic College,26599,3,0,3
4599,2013,Freeman Catholic College,15040,3,2,1
4600,2013,Freeman Catholic College,26199,1,0,1
4601,2013,Freeman Catholic College,15800,1,0,1
4602,2013,Freeman Catholic College,15140,18,4,14
4603,2013,Freeman Catholic College,15050,1,1,0
4604,2013,Freeman Catholic College,15210,3,3,0
4605,2013,Freeman Catholic College,15290,1,0,1
4606,2013,Freeman Catholic College,15250,8,6,2
4607,2013,Freeman Catholic College,15220,2,1,1
4608,2013,Freeman Catholic College,15020,8,1,7
4609,2013,Shellharbour Anglican College,15270,1,0,1
4610,2013,Shellharbour Anglican College,15230,2,1,1
4611,2013,Shellharbour Anglican College,15080,2,2,0
4612,2013,Shellharbour Anglican College,15290,2,2,0
4613,2013,Shellharbour Anglican College,15250,1,1,0
4614,2013,Shellharbour Anglican College,15020,1,0,1
4615,2013,Shellharbour Anglican College,15390,1,0,1
4616,2013,Matraville Sports High School,15200,1,1,0
4617,2013,Sydney Distance Education High School,15230,3,1,2
4618,2013,Sydney Distance Education High School,15190,1,0,1
4619,2013,Sydney Distance Education High School,15070,2,1,1
4620,2013,Sydney Distance Education High School,26599,1,0,1
4621,2013,Sydney Distance Education High School,15400,1,1,0
4622,2013,Sydney Distance Education High School,15020,1,0,1
4623,2013,Sydney Distance Education High School,15390,1,0,1
4624,2013,Dungog High School,15170,1,0,1
4625,2013,Dungog High School,15200,1,1,0
4626,2013,Dungog High School,15110,1,0,1
4627,2013,Dungog High School,15030,1,0,1
4628,2013,Dungog High School,15050,1,0,1
4629,2013,Miller High School,15260,1,1,0
4630,2013,Miller High School,15520,1,0,1
4631,2013,Miller High School,15250,1,1,0
4632,2013,Coffs Harbour Christian Community School,15230,7,3,4
4633,2013,Coffs Harbour Christian Community School,15200,5,4,1
4634,2013,Coffs Harbour Christian Community School,15750,1,0,1
4635,2013,Coffs Harbour Christian Community School,15050,1,1,0
4636,2013,Coffs Harbour Christian Community School,15290,5,3,2
4637,2013,Coffs Harbour Christian Community School,15250,2,2,0
4638,2013,Wade High School,15240,1,1,0
4639,2013,Wade High School,26899,1,1,0
4640,2013,Wade High School,15340,1,0,1
4641,2013,Wade High School,15030,1,1,0
4642,2013,Wade High School,15790,1,0,1
4643,2013,Wade High School,15700,2,0,2
4644,2013,Jindabyne Central School,15160,1,0,1
4645,2013,Jindabyne Central School,15030,1,0,1
4646,2013,Belmore Boys High School,15040,2,2,0
4647,2013,Belmore Boys High School,15220,1,1,0
4648,2013,Nepean Creative and Performing Arts High School,15340,1,0,1
4649,2013,Nepean Creative and Performing Arts High School,15170,1,0,1
4650,2013,Nepean Creative and Performing Arts High School,15160,1,1,0
4651,2013,Nepean Creative and Performing Arts High School,15100,1,1,0
4652,2013,Nepean Creative and Performing Arts High School,15290,2,1,1
4653,2013,Good Samaritan Catholic College,15240,7,6,1
4654,2013,Good Samaritan Catholic College,15270,1,0,1
4655,2013,Good Samaritan Catholic College,15230,21,12,9
4656,2013,Good Samaritan Catholic College,16080,1,1,0
4657,2013,Good Samaritan Catholic College,15090,1,1,0
4658,2013,Good Samaritan Catholic College,15320,1,0,1
4659,2013,Good Samaritan Catholic College,15280,2,0,2
4660,2013,Good Samaritan Catholic College,15200,1,1,0
4661,2013,Good Samaritan Catholic College,15380,3,2,1
4662,2013,Good Samaritan Catholic College,16090,1,1,0
4663,2013,Good Samaritan Catholic College,15110,3,3,0
4664,2013,Good Samaritan Catholic College,15030,1,1,0
4665,2013,Good Samaritan Catholic College,15370,13,7,6
4666,2013,Good Samaritan Catholic College,15330,3,3,0
4667,2013,Good Samaritan Catholic College,15400,1,0,1
4668,2013,Good Samaritan Catholic College,15040,6,6,0
4669,2013,Good Samaritan Catholic College,15800,1,1,0
4670,2013,Good Samaritan Catholic College,15060,1,1,0
4671,2013,Good Samaritan Catholic College,15140,2,1,1
4672,2013,Good Samaritan Catholic College,15130,1,1,0
4673,2013,Good Samaritan Catholic College,15050,1,1,0
4674,2013,Good Samaritan Catholic College,15210,3,3,0
4675,2013,Good Samaritan Catholic College,15290,2,1,1
4676,2013,Good Samaritan Catholic College,15250,4,4,0
4677,2013,Good Samaritan Catholic College,15220,4,4,0
4678,2013,Oxford Falls Grammar School,15240,1,0,1
4679,2013,Oxford Falls Grammar School,15230,6,3,3
4680,2013,Oxford Falls Grammar School,15190,1,0,1
4681,2013,Oxford Falls Grammar School,15080,1,0,1
4682,2013,Oxford Falls Grammar School,15320,2,0,2
4683,2013,Oxford Falls Grammar School,15110,2,1,1
4684,2013,Oxford Falls Grammar School,27099,1,0,1
4685,2013,Oxford Falls Grammar School,15030,1,0,1
4686,2013,Oxford Falls Grammar School,15400,3,1,2
4687,2013,Oxford Falls Grammar School,15040,4,1,3
4688,2013,Oxford Falls Grammar School,15180,1,0,1
4689,2013,Oxford Falls Grammar School,15140,4,1,3
4690,2013,Oxford Falls Grammar School,15290,1,1,0
4691,2013,Oxford Falls Grammar School,15220,4,1,3
4692,2013,Oxford Falls Grammar School,15020,1,1,0
4693,2013,St John's College,15240,2,2,0
4694,2013,St John's College,26899,3,1,2
4695,2013,St John's College,15270,5,2,3
4696,2013,St John's College,15340,2,1,1
4697,2013,St John's College,26999,1,0,1
4698,2013,St John's College,15170,1,0,1
4699,2013,St John's College,15230,11,6,5
4700,2013,St John's College,15360,1,1,0
4701,2013,St John's College,15090,1,0,1
4702,2013,St John's College,15320,3,1,2
4703,2013,St John's College,15670,1,0,1
4704,2013,St John's College,15350,3,2,1
4705,2013,St John's College,15200,2,2,0
4706,2013,St John's College,15380,5,1,4
4707,2013,St John's College,15160,4,2,2
4708,2013,St John's College,15030,1,1,0
4709,2013,St John's College,15370,9,3,6
4710,2013,St John's College,15330,2,2,0
4711,2013,St John's College,15400,5,0,5
4712,2013,St John's College,15100,1,0,1
4713,2013,St John's College,15060,2,0,2
4714,2013,St John's College,15140,11,5,6
4715,2013,St John's College,15130,1,0,1
4716,2013,St John's College,15050,2,2,0
4717,2013,St John's College,15290,1,0,1
4718,2013,St John's College,15250,3,3,0
4719,2013,St John's College,15220,6,2,4
4720,2013,St John's College,15020,6,3,3
4721,2013,St John's College,15390,1,0,1
4722,2013,Belmont Christian College,15170,1,0,1
4723,2013,Belmont Christian College,15230,2,0,2
4724,2013,Belmont Christian College,15320,1,1,0
4725,2013,Belmont Christian College,15200,2,1,1
4726,2013,Belmont Christian College,15160,1,0,1
4727,2013,Belmont Christian College,15400,1,0,1
4728,2013,Belmont Christian College,15290,2,0,2
4729,2013,Belmont Christian College,15390,3,0,3
4730,2013,Tara Anglican School for Girls,15240,3,0,3
4731,2013,Tara Anglican School for Girls,15270,3,0,3
4732,2013,Tara Anglican School for Girls,15230,7,0,7
4733,2013,Tara Anglican School for Girls,15090,4,0,4
4734,2013,Tara Anglican School for Girls,15320,3,0,3
4735,2013,Tara Anglican School for Girls,15280,7,0,7
4736,2013,Tara Anglican School for Girls,15160,1,0,1
4737,2013,Tara Anglican School for Girls,15110,1,0,1
4738,2013,Tara Anglican School for Girls,15710,1,0,1
4739,2013,Tara Anglican School for Girls,15680,3,0,3
4740,2013,Tara Anglican School for Girls,15030,6,0,6
4741,2013,Tara Anglican School for Girls,15370,4,0,4
4742,2013,Tara Anglican School for Girls,26599,1,0,1
4743,2013,Tara Anglican School for Girls,15400,1,0,1
4744,2013,Tara Anglican School for Girls,15040,4,0,4
4745,2013,Tara Anglican School for Girls,15180,3,0,3
4746,2013,Tara Anglican School for Girls,15140,9,0,9
4747,2013,Tara Anglican School for Girls,15050,1,0,1
4748,2013,Tara Anglican School for Girls,15290,2,0,2
4749,2013,Tara Anglican School for Girls,15250,4,1,3
4750,2013,Tara Anglican School for Girls,15220,2,0,2
4751,2013,Tara Anglican School for Girls,15020,3,0,3
4752,2013,Xavier High School,15240,1,1,0
4753,2013,Xavier High School,15340,1,1,0
4754,2013,Xavier High School,15230,3,1,2
4755,2013,Xavier High School,15360,1,1,0
4756,2013,Xavier High School,15320,2,0,2
4757,2013,Xavier High School,15350,2,0,2
4758,2013,Xavier High School,15200,2,1,1
4759,2013,Xavier High School,15370,1,0,1
4760,2013,Xavier High School,15330,1,1,0
4761,2013,Xavier High School,15060,2,0,2
4762,2013,Xavier High School,15290,1,0,1
4763,2013,Barker College,15240,32,26,6
4764,2013,Barker College,15270,18,16,2
4765,2013,Barker College,15170,7,4,3
4766,2013,Barker College,15230,52,30,22
4767,2013,Barker College,15190,11,8,3
4768,2013,Barker College,15080,5,2,3
4769,2013,Barker College,15360,3,3,0
4770,2013,Barker College,15090,19,7,12
4771,2013,Barker College,15320,20,15,5
4772,2013,Barker College,15280,4,3,1
4773,2013,Barker College,15200,5,5,0
4774,2013,Barker College,15160,21,13,8
4775,2013,Barker College,15300,6,6,0
4776,2013,Barker College,15110,13,13,0
4777,2013,Barker College,15680,2,1,1
4778,2013,Barker College,15260,12,12,0
4779,2013,Barker College,15030,18,9,9
4780,2013,Barker College,15370,4,3,1
4781,2013,Barker College,15310,8,6,2
4782,2013,Barker College,15330,16,13,3
4783,2013,Barker College,15400,8,1,7
4784,2013,Barker College,15100,24,17,7
4785,2013,Barker College,15040,21,18,3
4786,2013,Barker College,15140,26,18,8
4787,2013,Barker College,15130,1,1,0
4788,2013,Barker College,15050,19,15,4
4789,2013,Barker College,15290,7,2,5
4790,2013,Barker College,15250,29,26,3
4791,2013,Barker College,15690,1,0,1
4792,2013,Barker College,15220,36,27,9
4793,2013,Barker College,15020,17,4,13
4794,2013,Barker College,15010,6,4,2
4795,2013,Tumut High School,26999,2,0,2
4796,2013,Tumut High School,15120,1,1,0
4797,2013,Tumut High School,15320,1,0,1
4798,2013,Tumut High School,15030,1,0,1
4799,2013,Tumut High School,15180,1,0,1
4800,2013,Tumut High School,15290,2,1,1
4801,2013,Marist Sisters' College Woolwich,15240,2,0,2
4802,2013,Marist Sisters' College Woolwich,15270,5,0,5
4803,2013,Marist Sisters' College Woolwich,15340,2,0,2
4804,2013,Marist Sisters' College Woolwich,15230,8,1,7
4805,2013,Marist Sisters' College Woolwich,15080,1,0,1
4806,2013,Marist Sisters' College Woolwich,15720,1,0,1
4807,2013,Marist Sisters' College Woolwich,15090,1,0,1
4808,2013,Marist Sisters' College Woolwich,15320,4,0,4
4809,2013,Marist Sisters' College Woolwich,15280,1,0,1
4810,2013,Marist Sisters' College Woolwich,15380,1,0,1
4811,2013,Marist Sisters' College Woolwich,15160,4,0,4
4812,2013,Marist Sisters' College Woolwich,15710,1,0,1
4813,2013,Marist Sisters' College Woolwich,15030,2,0,2
4814,2013,Marist Sisters' College Woolwich,15370,12,0,12
4815,2013,Marist Sisters' College Woolwich,15310,2,0,2
4816,2013,Marist Sisters' College Woolwich,15620,1,0,1
4817,2013,Marist Sisters' College Woolwich,15400,4,0,4
4818,2013,Marist Sisters' College Woolwich,16100,1,0,1
4819,2013,Marist Sisters' College Woolwich,15040,1,0,1
4820,2013,Marist Sisters' College Woolwich,15060,3,0,3
4821,2013,Marist Sisters' College Woolwich,15140,17,0,17
4822,2013,Marist Sisters' College Woolwich,15130,2,0,2
4823,2013,Marist Sisters' College Woolwich,15050,1,0,1
4824,2013,Marist Sisters' College Woolwich,15210,5,0,5
4825,2013,Marist Sisters' College Woolwich,15290,3,0,3
4826,2013,Marist Sisters' College Woolwich,15250,3,0,3
4827,2013,Marist Sisters' College Woolwich,15220,9,0,9
4828,2013,Marist Sisters' College Woolwich,15020,11,1,10
4829,2013,Marist Sisters' College Woolwich,15390,1,0,1
4830,2013,Casula High School,15240,1,1,0
4831,2013,Casula High School,15540,1,0,1
4832,2013,Casula High School,15330,2,1,1
4833,2013,Casula High School,15400,1,0,1
4834,2013,Casula High School,15060,2,0,2
4835,2013,Casula High School,15250,2,1,1
4836,2013,Ashfield Boys High School,15240,3,3,0
4837,2013,Ashfield Boys High School,15230,4,4,0
4838,2013,Ashfield Boys High School,15110,1,1,0
4839,2013,Ashfield Boys High School,15560,1,0,1
4840,2013,Ashfield Boys High School,15260,1,1,0
4841,2013,Ashfield Boys High School,15330,3,3,0
4842,2013,Ashfield Boys High School,15150,1,1,0
4843,2013,Ashfield Boys High School,15140,1,1,0
4844,2013,Ashfield Boys High School,15050,1,1,0
4845,2013,Ashfield Boys High School,15210,2,2,0
4846,2013,Ashfield Boys High School,15290,1,1,0
4847,2013,Ashfield Boys High School,15250,7,6,1
4848,2013,Nowra Anglican College,15240,2,1,1
4849,2013,Nowra Anglican College,15270,2,1,1
4850,2013,Nowra Anglican College,15080,1,1,0
4851,2013,Nowra Anglican College,15350,1,1,0
4852,2013,Nowra Anglican College,16070,1,0,1
4853,2013,Nowra Anglican College,15330,1,1,0
4854,2013,Nowra Anglican College,15290,1,1,0
4855,2013,St Mary's Cathedral College,15240,19,19,0
4856,2013,St Mary's Cathedral College,15340,2,2,0
4857,2013,St Mary's Cathedral College,15230,8,8,0
4858,2013,St Mary's Cathedral College,15120,3,3,0
4859,2013,St Mary's Cathedral College,15090,1,1,0
4860,2013,St Mary's Cathedral College,15200,6,6,0
4861,2013,St Mary's Cathedral College,15300,1,1,0
4862,2013,St Mary's Cathedral College,15110,3,3,0
4863,2013,St Mary's Cathedral College,15260,2,2,0
4864,2013,St Mary's Cathedral College,15030,4,4,0
4865,2013,St Mary's Cathedral College,15370,9,9,0
4866,2013,St Mary's Cathedral College,15310,2,2,0
4867,2013,St Mary's Cathedral College,15970,1,1,0
4868,2013,St Mary's Cathedral College,15330,2,2,0
4869,2013,St Mary's Cathedral College,15400,1,1,0
4870,2013,St Mary's Cathedral College,15040,8,8,0
4871,2013,St Mary's Cathedral College,15140,2,2,0
4872,2013,St Mary's Cathedral College,15050,3,3,0
4873,2013,St Mary's Cathedral College,15210,2,2,0
4874,2013,St Mary's Cathedral College,15290,1,1,0
4875,2013,St Mary's Cathedral College,15250,8,8,0
4876,2013,St Mary's Cathedral College,15220,1,1,0
4877,2013,St Mary's Cathedral College,15020,1,1,0
4878,2013,Patrician Brothers' College Fairfield,15240,13,13,0
4879,2013,Patrician Brothers' College Fairfield,15340,4,4,0
4880,2013,Patrician Brothers' College Fairfield,15230,3,3,0
4881,2013,Patrician Brothers' College Fairfield,15380,1,1,0
4882,2013,Patrician Brothers' College Fairfield,15160,2,2,0
4883,2013,Patrician Brothers' College Fairfield,15110,2,2,0
4884,2013,Patrician Brothers' College Fairfield,15260,1,1,0
4885,2013,Patrician Brothers' College Fairfield,15030,3,3,0
4886,2013,Patrician Brothers' College Fairfield,15370,7,7,0
4887,2013,Patrician Brothers' College Fairfield,15330,2,2,0
4888,2013,Patrician Brothers' College Fairfield,15040,2,2,0
4889,2013,Patrician Brothers' College Fairfield,15140,9,9,0
4890,2013,Patrician Brothers' College Fairfield,15050,1,1,0
4891,2013,Patrician Brothers' College Fairfield,15250,10,10,0
4892,2013,Patrician Brothers' College Fairfield,15220,1,1,0
4893,2013,Patrician Brothers' College Fairfield,15020,3,3,0
4894,2013,John Edmondson High School,15240,2,1,1
4895,2013,John Edmondson High School,15340,1,1,0
4896,2013,John Edmondson High School,15230,3,3,0
4897,2013,John Edmondson High School,16080,1,0,1
4898,2013,John Edmondson High School,15320,1,0,1
4899,2013,John Edmondson High School,15200,1,0,1
4900,2013,John Edmondson High School,15110,1,1,0
4901,2013,John Edmondson High School,15330,1,1,0
4902,2013,John Edmondson High School,15040,1,1,0
4903,2013,John Edmondson High School,15180,1,0,1
4904,2013,John Edmondson High School,15060,3,0,3
4905,2013,John Edmondson High School,15210,1,0,1
4906,2013,Tuggerah Lakes Secondary College The Entrance Campus,15240,1,1,0
4907,2013,Tuggerah Lakes Secondary College The Entrance Campus,15340,3,1,2
4908,2013,Tuggerah Lakes Secondary College The Entrance Campus,15230,1,1,0
4909,2013,Tuggerah Lakes Secondary College The Entrance Campus,15080,1,0,1
4910,2013,Tuggerah Lakes Secondary College The Entrance Campus,15830,1,1,0
4911,2013,Tuggerah Lakes Secondary College The Entrance Campus,15320,2,1,1
4912,2013,Tuggerah Lakes Secondary College The Entrance Campus,15670,1,0,1
4913,2013,Tuggerah Lakes Secondary College The Entrance Campus,15350,1,0,1
4914,2013,Tuggerah Lakes Secondary College The Entrance Campus,15200,2,2,0
4915,2013,Tuggerah Lakes Secondary College The Entrance Campus,15100,1,1,0
4916,2013,Tuggerah Lakes Secondary College The Entrance Campus,15180,1,0,1
4917,2013,Tuggerah Lakes Secondary College The Entrance Campus,15060,6,0,6
4918,2013,Tuggerah Lakes Secondary College The Entrance Campus,15290,3,3,0
4919,2013,Tuggerah Lakes Secondary College The Entrance Campus,15390,1,0,1
4920,2013,Narooma High School,15090,1,0,1
4921,2013,Narooma High School,15320,1,1,0
4922,2013,Narooma High School,15200,4,4,0
4923,2013,Narooma High School,15160,2,0,2
4924,2013,Narooma High School,15140,2,0,2
4925,2013,Narooma High School,15130,1,1,0
4926,2013,Narooma High School,15290,2,2,0
4927,2013,Narooma High School,15020,1,0,1
4928,2013,New England Girls' School,15240,1,0,1
4929,2013,New England Girls' School,15080,2,0,2
4930,2013,New England Girls' School,15300,1,0,1
4931,2013,New England Girls' School,15060,1,0,1
4932,2013,New England Girls' School,15140,2,0,2
4933,2013,New England Girls' School,15290,1,0,1
4934,2013,St Patrick's College Sutherland,15240,13,11,2
4935,2013,St Patrick's College Sutherland,15270,1,0,1
4936,2013,St Patrick's College Sutherland,15340,4,3,1
4937,2013,St Patrick's College Sutherland,26999,3,0,3
4938,2013,St Patrick's College Sutherland,15230,6,1,5
4939,2013,St Patrick's College Sutherland,15120,6,6,0
4940,2013,St Patrick's College Sutherland,15090,5,0,5
4941,2013,St Patrick's College Sutherland,15320,3,1,2
4942,2013,St Patrick's College Sutherland,15200,5,5,0
4943,2013,St Patrick's College Sutherland,15380,2,0,2
4944,2013,St Patrick's College Sutherland,15160,2,0,2
4945,2013,St Patrick's College Sutherland,15030,2,1,1
4946,2013,St Patrick's College Sutherland,15370,9,2,7
4947,2013,St Patrick's College Sutherland,26599,1,0,1
4948,2013,St Patrick's College Sutherland,15400,5,3,2
4949,2013,St Patrick's College Sutherland,15040,3,1,2
4950,2013,St Patrick's College Sutherland,15060,4,0,4
4951,2013,St Patrick's College Sutherland,15140,3,0,3
4952,2013,St Patrick's College Sutherland,15290,4,2,2
4953,2013,St Patrick's College Sutherland,15250,8,5,3
4954,2013,St Patrick's College Sutherland,15220,2,0,2
4955,2013,Murwillumbah High School,15340,1,1,0
4956,2013,Murwillumbah High School,15290,1,1,0
4957,2013,St Paul's Grammar School,15230,1,1,0
4958,2013,Albion Park High School,15230,1,1,0
4959,2013,Albion Park High School,15400,1,1,0
4960,2013,Albion Park High School,15060,5,2,3
4961,2013,Albion Park High School,15390,1,0,1
4962,2013,Border Christian College,15340,1,1,0
4963,2013,Punchbowl Boys High School,15040,1,1,0
4964,2013,Northern Beaches Secondary College Manly Campus,15240,45,24,21
4965,2013,Northern Beaches Secondary College Manly Campus,15270,20,2,18
4966,2013,Northern Beaches Secondary College Manly Campus,15170,1,0,1
4967,2013,Northern Beaches Secondary College Manly Campus,15080,1,0,1
4968,2013,Northern Beaches Secondary College Manly Campus,15120,4,4,0
4969,2013,Northern Beaches Secondary College Manly Campus,15720,1,0,1
4970,2013,Northern Beaches Secondary College Manly Campus,15360,3,3,0
4971,2013,Northern Beaches Secondary College Manly Campus,15090,6,0,6
4972,2013,Northern Beaches Secondary College Manly Campus,15280,5,0,5
4973,2013,Northern Beaches Secondary College Manly Campus,15670,2,1,1
4974,2013,Northern Beaches Secondary College Manly Campus,15350,12,4,8
4975,2013,Northern Beaches Secondary College Manly Campus,15820,1,0,1
4976,2013,Northern Beaches Secondary College Manly Campus,15160,13,2,11
4977,2013,Northern Beaches Secondary College Manly Campus,15300,6,5,1
4978,2013,Northern Beaches Secondary College Manly Campus,15110,7,3,4
4979,2013,Northern Beaches Secondary College Manly Campus,15710,2,0,2
4980,2013,Northern Beaches Secondary College Manly Campus,15680,3,0,3
4981,2013,Northern Beaches Secondary College Manly Campus,15540,1,0,1
4982,2013,Northern Beaches Secondary College Manly Campus,15260,8,7,1
4983,2013,Northern Beaches Secondary College Manly Campus,15030,20,8,12
4984,2013,Northern Beaches Secondary College Manly Campus,15790,2,0,2
4985,2013,Northern Beaches Secondary College Manly Campus,15310,4,3,1
4986,2013,Northern Beaches Secondary College Manly Campus,15330,9,6,3
4987,2013,Northern Beaches Secondary College Manly Campus,15400,11,3,8
4988,2013,Northern Beaches Secondary College Manly Campus,15555,2,1,1
4989,2013,Northern Beaches Secondary College Manly Campus,15040,10,3,7
4990,2013,Northern Beaches Secondary College Manly Campus,15180,1,0,1
4991,2013,Northern Beaches Secondary College Manly Campus,15140,34,7,27
4992,2013,Northern Beaches Secondary College Manly Campus,15050,12,8,4
4993,2013,Northern Beaches Secondary College Manly Campus,15250,34,20,14
4994,2013,Northern Beaches Secondary College Manly Campus,15220,4,3,1
4995,2013,Northern Beaches Secondary College Manly Campus,15020,15,4,11
4996,2013,Northern Beaches Secondary College Manly Campus,15390,4,0,4
4997,2013,Northern Beaches Secondary College Manly Campus,15700,2,0,2
4998,2013,Canley Vale High School,15240,31,16,15
4999,2013,Canley Vale High School,15270,8,0,8
5000,2013,Canley Vale High School,15340,7,4,3
5001,2013,Canley Vale High School,15230,7,4,3
5002,2013,Canley Vale High School,15830,1,1,0
5003,2013,Canley Vale High School,15280,2,0,2
5004,2013,Canley Vale High School,15260,9,4,5
5005,2013,Canley Vale High School,15030,1,0,1
5006,2013,Canley Vale High School,15330,3,2,1
5007,2013,Canley Vale High School,15040,3,1,2
5008,2013,Canley Vale High School,15060,1,0,1
5009,2013,Canley Vale High School,15140,2,0,2
5010,2013,Canley Vale High School,15130,4,1,3
5011,2013,Canley Vale High School,15050,5,2,3
5012,2013,Canley Vale High School,15210,2,1,1
5013,2013,Canley Vale High School,15290,1,0,1
5014,2013,Canley Vale High School,15250,26,13,13
5015,2013,Canley Vale High School,15220,2,0,2
5016,2013,Canley Vale High School,15020,2,0,2
5017,2013,Cronulla High School,15240,2,2,0
5018,2013,Cronulla High School,15270,1,1,0
5019,2013,Cronulla High School,15230,1,0,1
5020,2013,Cronulla High School,15080,3,0,3
5021,2013,Cronulla High School,15090,2,1,1
5022,2013,Cronulla High School,15350,2,0,2
5023,2013,Cronulla High School,15200,8,6,2
5024,2013,Cronulla High School,15030,1,0,1
5025,2013,Cronulla High School,15330,1,1,0
5026,2013,Cronulla High School,15040,1,0,1
5027,2013,Cronulla High School,15060,2,0,2
5028,2013,Cronulla High School,15130,1,0,1
5029,2013,Cronulla High School,15050,2,2,0
5030,2013,Cronulla High School,15250,2,2,0
5031,2013,Cronulla High School,15220,2,0,2
5032,2013,Cronulla High School,15020,1,0,1
5033,2013,Mountains Christian College,15290,1,1,0
5034,2013,St Euphemia College,15080,3,0,3
5035,2013,St Euphemia College,15320,1,0,1
5036,2013,St Euphemia College,15110,3,0,3
5037,2013,St Euphemia College,15980,6,2,4
5038,2013,St Euphemia College,26599,1,0,1
5039,2013,St Euphemia College,15990,5,1,4
5040,2013,St Euphemia College,15180,2,1,1
5041,2013,St Euphemia College,15140,3,0,3
5042,2013,St Euphemia College,15210,1,1,0
5043,2013,St Euphemia College,15220,7,2,5
5044,2013,The Scots School Albury,15240,1,0,1
5045,2013,The Scots School Albury,15270,1,1,0
5046,2013,The Scots School Albury,15170,1,0,1
5047,2013,The Scots School Albury,15230,6,2,4
5048,2013,The Scots School Albury,15080,1,0,1
5049,2013,The Scots School Albury,15090,2,1,1
5050,2013,The Scots School Albury,15320,9,2,7
5051,2013,The Scots School Albury,15280,2,1,1
5052,2013,The Scots School Albury,26799,1,1,0
5053,2013,The Scots School Albury,15680,1,0,1
5054,2013,The Scots School Albury,15260,2,1,1
5055,2013,The Scots School Albury,15030,4,0,4
5056,2013,The Scots School Albury,26599,1,0,1
5057,2013,The Scots School Albury,15040,2,0,2
5058,2013,The Scots School Albury,15140,4,1,3
5059,2013,The Scots School Albury,15050,2,0,2
5060,2013,The Scots School Albury,15290,6,4,2
5061,2013,The Scots School Albury,15250,4,2,2
5062,2013,The Scots School Albury,15690,1,0,1
5063,2013,The Scots School Albury,15020,6,2,4
5064,2013,The Scots School Albury,15010,1,0,1
5065,2013,James Cook Boys High School,15240,1,1,0
5066,2013,James Cook Boys High School,15120,1,1,0
5067,2013,James Cook Boys High School,15050,1,1,0
5068,2013,James Cook Boys High School,15250,1,1,0
5069,2013,Picton High School,15340,2,1,1
5070,2013,Picton High School,15230,1,1,0
5071,2013,Picton High School,27199,1,0,1
5072,2013,Picton High School,15210,1,1,0
5073,2013,Clarence Valley Anglican School,15350,1,0,1
5074,2013,Nambucca Heads High School,15030,1,0,1
5075,2013,Nambucca Heads High School,15400,1,1,0
5076,2013,Nambucca Heads High School,15180,2,0,2
5077,2013,Crestwood High School,15240,5,4,1
5078,2013,Crestwood High School,15170,1,0,1
5079,2013,Crestwood High School,15230,6,1,5
5080,2013,Crestwood High School,15120,1,1,0
5081,2013,Crestwood High School,15350,1,0,1
5082,2013,Crestwood High School,15200,2,2,0
5083,2013,Crestwood High School,15110,1,1,0
5084,2013,Crestwood High School,26699,1,1,0
5085,2013,Crestwood High School,15030,1,0,1
5086,2013,Crestwood High School,15400,2,0,2
5087,2013,Crestwood High School,15180,4,0,4
5088,2013,Crestwood High School,15060,3,0,3
5089,2013,Crestwood High School,15250,1,1,0
5090,2013,Inaburra School,15240,3,1,2
5091,2013,Inaburra School,15230,14,8,6
5092,2013,Inaburra School,15190,2,2,0
5093,2013,Inaburra School,15280,1,0,1
5094,2013,Inaburra School,15200,1,1,0
5095,2013,Inaburra School,15160,1,0,1
5096,2013,Inaburra School,15300,2,0,2
5097,2013,Inaburra School,15030,5,0,5
5098,2013,Inaburra School,15310,3,1,2
5099,2013,Inaburra School,15400,1,0,1
5100,2013,Inaburra School,15100,1,0,1
5101,2013,Inaburra School,15040,7,1,6
5102,2013,Inaburra School,15180,1,0,1
5103,2013,Inaburra School,15060,7,0,7
5104,2013,Inaburra School,15140,9,1,8
5105,2013,Inaburra School,15210,2,2,0
5106,2013,Inaburra School,15290,6,2,4
5107,2013,Inaburra School,15250,1,0,1
5108,2013,Inaburra School,15220,2,1,1
5109,2013,Inaburra School,15390,2,0,2
5110,2013,St John The Evangelist Catholic High School,15240,2,1,1
5111,2013,St John The Evangelist Catholic High School,15270,1,0,1
5112,2013,St John The Evangelist Catholic High School,15170,1,0,1
5113,2013,St John The Evangelist Catholic High School,15230,8,3,5
5114,2013,St John The Evangelist Catholic High School,15080,1,0,1
5115,2013,St John The Evangelist Catholic High School,15090,4,0,4
5116,2013,St John The Evangelist Catholic High School,15320,1,0,1
5117,2013,St John The Evangelist Catholic High School,15280,1,0,1
5118,2013,St John The Evangelist Catholic High School,15200,1,1,0
5119,2013,St John The Evangelist Catholic High School,15380,2,0,2
5120,2013,St John The Evangelist Catholic High School,15160,3,1,2
5121,2013,St John The Evangelist Catholic High School,15680,2,1,1
5122,2013,St John The Evangelist Catholic High School,15030,3,2,1
5123,2013,St John The Evangelist Catholic High School,15370,5,1,4
5124,2013,St John The Evangelist Catholic High School,15060,1,0,1
5125,2013,St John The Evangelist Catholic High School,15140,3,1,2
5126,2013,St John The Evangelist Catholic High School,15130,1,1,0
5127,2013,St John The Evangelist Catholic High School,15050,1,1,0
5128,2013,St John The Evangelist Catholic High School,15290,3,1,2
5129,2013,St John The Evangelist Catholic High School,15250,1,0,1
5130,2013,St John The Evangelist Catholic High School,15020,3,0,3
5131,2013,Tamworth High School,15230,1,0,1
5132,2013,Tamworth High School,15320,1,0,1
5133,2013,Tamworth High School,15200,1,1,0
5134,2013,Tamworth High School,15300,1,1,0
5135,2013,Tamworth High School,15040,2,0,2
5136,2013,Carroll College,15240,3,3,0
5137,2013,Carroll College,15230,5,3,2
5138,2013,Carroll College,15200,3,3,0
5139,2013,Carroll College,15160,1,1,0
5140,2013,Carroll College,15330,1,1,0
5141,2013,Carroll College,15400,1,0,1
5142,2013,Carroll College,15060,1,0,1
5143,2013,Carroll College,15050,1,1,0
5144,2013,Carroll College,15290,4,3,1
5145,2013,Carroll College,15250,1,1,0
5146,2013,Carroll College,15220,1,0,1
5147,2013,All Saints College (St Mary's Campus),15240,3,3,0
5148,2013,All Saints College (St Mary's Campus),15270,1,0,1
5149,2013,All Saints College (St Mary's Campus),15230,3,1,2
5150,2013,All Saints College (St Mary's Campus),15190,1,1,0
5151,2013,All Saints College (St Mary's Campus),15320,1,1,0
5152,2013,All Saints College (St Mary's Campus),15670,1,1,0
5153,2013,All Saints College (St Mary's Campus),15350,2,0,2
5154,2013,All Saints College (St Mary's Campus),15200,3,3,0
5155,2013,All Saints College (St Mary's Campus),15380,2,1,1
5156,2013,All Saints College (St Mary's Campus),15160,3,0,3
5157,2013,All Saints College (St Mary's Campus),15110,2,1,1
5158,2013,All Saints College (St Mary's Campus),15030,3,2,1
5159,2013,All Saints College (St Mary's Campus),15370,10,3,7
5160,2013,All Saints College (St Mary's Campus),15330,1,1,0
5161,2013,All Saints College (St Mary's Campus),15400,1,0,1
5162,2013,All Saints College (St Mary's Campus),15040,2,1,1
5163,2013,All Saints College (St Mary's Campus),15060,1,0,1
5164,2013,All Saints College (St Mary's Campus),15140,5,0,5
5165,2013,All Saints College (St Mary's Campus),15210,4,3,1
5166,2013,All Saints College (St Mary's Campus),15290,1,1,0
5167,2013,All Saints College (St Mary's Campus),15220,14,4,10
5168,2013,All Saints College (St Mary's Campus),15020,2,2,0
5169,2013,Al Amanah College,15110,1,1,0
5170,2013,Al Amanah College,15030,1,1,0
5171,2013,Al Amanah College,15330,1,1,0
5172,2013,Al Amanah College,15040,2,1,1
5173,2013,Galston High School,15240,2,1,1
5174,2013,Galston High School,15270,1,0,1
5175,2013,Galston High School,15120,1,1,0
5176,2013,Galston High School,15890,1,0,1
5177,2013,Galston High School,15280,3,0,3
5178,2013,Galston High School,15200,3,2,1
5179,2013,Galston High School,15300,1,1,0
5180,2013,Galston High School,15560,1,1,0
5181,2013,Galston High School,15310,1,1,0
5182,2013,Galston High School,15150,2,0,2
5183,2013,Galston High School,15400,3,1,2
5184,2013,Galston High School,15040,2,0,2
5185,2013,Galston High School,15180,2,0,2
5186,2013,Galston High School,15140,2,1,1
5187,2013,Galston High School,15050,1,0,1
5188,2013,Galston High School,15290,1,1,0
5189,2013,Galston High School,15250,2,1,1
5190,2013,Galston High School,15220,2,0,2
5191,2013,Galston High School,15020,2,0,2
5192,2013,Galston High School,15010,3,1,2
5193,2013,Muirfield High School,15240,1,1,0
5194,2013,Muirfield High School,26899,1,1,0
5195,2013,Muirfield High School,15230,1,0,1
5196,2013,Muirfield High School,15320,1,0,1
5197,2013,Muirfield High School,26699,2,2,0
5198,2013,Muirfield High School,15030,1,0,1
5199,2013,Muirfield High School,15330,1,1,0
5200,2013,Muirfield High School,15290,2,1,1
5201,2013,Muirfield High School,15250,1,1,0
5202,2013,Woolgoolga High School,15200,1,0,1
5203,2013,Parramatta Marist High School,15240,26,26,0
5204,2013,Parramatta Marist High School,15340,3,3,0
5205,2013,Parramatta Marist High School,15230,10,10,0
5206,2013,Parramatta Marist High School,15120,2,2,0
5207,2013,Parramatta Marist High School,16080,1,1,0
5208,2013,Parramatta Marist High School,15360,1,1,0
5209,2013,Parramatta Marist High School,15320,6,6,0
5210,2013,Parramatta Marist High School,15200,6,6,0
5211,2013,Parramatta Marist High School,15160,3,3,0
5212,2013,Parramatta Marist High School,15260,5,5,0
5213,2013,Parramatta Marist High School,15030,3,3,0
5214,2013,Parramatta Marist High School,15370,10,10,0
5215,2013,Parramatta Marist High School,15330,3,3,0
5216,2013,Parramatta Marist High School,15040,10,10,0
5217,2013,Parramatta Marist High School,15140,10,10,0
5218,2013,Parramatta Marist High School,15210,1,1,0
5219,2013,Parramatta Marist High School,15250,10,10,0
5220,2013,Parramatta Marist High School,15020,2,2,0
5221,2013,Illawarra Sports High School,15320,1,1,0
5222,2013,Illawarra Sports High School,15200,2,1,1
5223,2013,Illawarra Sports High School,15220,2,1,1
5224,2013,Banora Point High School,15320,1,0,1
5225,2013,Mercy Catholic College,15240,1,0,1
5226,2013,Mercy Catholic College,15270,7,1,6
5227,2013,Mercy Catholic College,15550,1,0,1
5228,2013,Mercy Catholic College,15280,5,0,5
5229,2013,Mercy Catholic College,15530,1,0,1
5230,2013,Mercy Catholic College,15350,1,0,1
5231,2013,Mercy Catholic College,15380,2,0,2
5232,2013,Mercy Catholic College,15160,3,0,3
5233,2013,Mercy Catholic College,15570,1,0,1
5234,2013,Mercy Catholic College,15370,7,1,6
5235,2013,Mercy Catholic College,15790,1,0,1
5236,2013,Mercy Catholic College,15400,1,0,1
5237,2013,Mercy Catholic College,15180,1,0,1
5238,2013,Mercy Catholic College,15140,7,1,6
5239,2013,Mercy Catholic College,15220,3,1,2
5240,2013,Mercy Catholic College,15020,4,0,4
5241,2013,St George Girls High School,15240,46,2,44
5242,2013,St George Girls High School,15270,13,2,11
5243,2013,St George Girls High School,15170,2,1,1
5244,2013,St George Girls High School,15230,9,2,7
5245,2013,St George Girls High School,15190,5,0,5
5246,2013,St George Girls High School,15830,8,0,8
5247,2013,St George Girls High School,15090,7,0,7
5248,2013,St George Girls High School,15850,6,0,6
5249,2013,St George Girls High School,15320,8,1,7
5250,2013,St George Girls High School,15280,3,1,2
5251,2013,St George Girls High School,15670,3,0,3
5252,2013,St George Girls High School,15160,14,1,13
5253,2013,St George Girls High School,15300,7,2,5
5254,2013,St George Girls High School,15110,12,1,11
5255,2013,St George Girls High School,15910,2,0,2
5256,2013,St George Girls High School,15540,1,0,1
5257,2013,St George Girls High School,15260,12,1,11
5258,2013,St George Girls High School,15900,3,0,3
5259,2013,St George Girls High School,15030,5,0,5
5260,2013,St George Girls High School,15310,6,1,5
5261,2013,St George Girls High School,15330,1,0,1
5262,2013,St George Girls High School,15760,2,0,2
5263,2013,St George Girls High School,15400,5,1,4
5264,2013,St George Girls High School,15100,1,0,1
5265,2013,St George Girls High School,15555,3,0,3
5266,2013,St George Girls High School,15040,16,1,15
5267,2013,St George Girls High School,15180,6,0,6
5268,2013,St George Girls High School,15140,42,4,38
5269,2013,St George Girls High School,15050,15,0,15
5270,2013,St George Girls High School,15210,5,1,4
5271,2013,St George Girls High School,15250,45,2,43
5272,2013,St George Girls High School,15220,27,1,26
5273,2013,St George Girls High School,15020,16,0,16
5274,2013,St George Girls High School,15390,5,0,5
5275,2013,Chevalier College Bowral,15240,2,2,0
5276,2013,Chevalier College Bowral,15270,3,1,2
5277,2013,Chevalier College Bowral,15340,1,0,1
5278,2013,Chevalier College Bowral,15170,2,1,1
5279,2013,Chevalier College Bowral,15230,1,1,0
5280,2013,Chevalier College Bowral,15080,2,1,1
5281,2013,Chevalier College Bowral,15090,3,2,1
5282,2013,Chevalier College Bowral,15320,4,1,3
5283,2013,Chevalier College Bowral,15280,4,0,4
5284,2013,Chevalier College Bowral,15350,3,1,2
5285,2013,Chevalier College Bowral,15200,1,1,0
5286,2013,Chevalier College Bowral,15160,2,1,1
5287,2013,Chevalier College Bowral,15260,1,1,0
5288,2013,Chevalier College Bowral,15030,1,0,1
5289,2013,Chevalier College Bowral,15370,4,2,2
5290,2013,Chevalier College Bowral,26599,1,0,1
5291,2013,Chevalier College Bowral,15140,5,1,4
5292,2013,Chevalier College Bowral,15290,2,0,2
5293,2013,Chevalier College Bowral,15250,2,2,0
5294,2013,Chevalier College Bowral,15220,1,0,1
5295,2013,Chevalier College Bowral,15010,1,0,1
5296,2013,Newcastle High School,15230,1,0,1
5297,2013,Newcastle High School,15670,2,1,1
5298,2013,Newcastle High School,15030,1,0,1
5299,2013,Newcastle High School,15140,1,0,1
5300,2013,St Joseph's High School Aberdeen,15340,1,1,0
5301,2013,St Joseph's High School Aberdeen,26999,1,0,1
5302,2013,St Joseph's High School Aberdeen,15170,1,0,1
5303,2013,St Joseph's High School Aberdeen,15230,2,2,0
5304,2013,St Joseph's High School Aberdeen,15090,1,0,1
5305,2013,St Joseph's High School Aberdeen,15320,5,2,3
5306,2013,St Joseph's High School Aberdeen,15200,1,1,0
5307,2013,St Joseph's High School Aberdeen,15030,1,1,0
5308,2013,St Joseph's High School Aberdeen,15040,1,1,0
5309,2013,St Joseph's High School Aberdeen,15060,1,0,1
5310,2013,St Joseph's High School Aberdeen,15140,1,0,1
5311,2013,St Joseph's High School Aberdeen,15290,2,2,0
5312,2013,Lithgow High School,15400,2,0,2
5313,2013,Lithgow High School,15290,1,0,1
5314,2013,Northholm Grammar School,15240,1,1,0
5315,2013,Northholm Grammar School,15270,5,3,2
5316,2013,Northholm Grammar School,15230,4,4,0
5317,2013,Northholm Grammar School,15080,3,1,2
5318,2013,Northholm Grammar School,15090,4,1,3
5319,2013,Northholm Grammar School,15160,1,1,0
5320,2013,Northholm Grammar School,15300,2,1,1
5321,2013,Northholm Grammar School,15310,2,2,0
5322,2013,Northholm Grammar School,15330,1,1,0
5323,2013,Northholm Grammar School,15140,1,1,0
5324,2013,Northholm Grammar School,15050,1,1,0
5325,2013,Northholm Grammar School,15290,3,2,1
5326,2013,Northholm Grammar School,15250,2,2,0
5327,2013,Northholm Grammar School,15220,1,0,1
5328,2013,Northholm Grammar School,15020,2,2,0
5329,2013,Wellington High School,15230,1,0,1
5330,2013,Wellington High School,15190,1,0,1
5331,2013,Wellington High School,15320,1,0,1
5332,2013,Wellington High School,15160,1,0,1
5333,2013,Wellington High School,15180,1,0,1
5334,2013,Wellington High School,15140,1,0,1
5335,2013,Wellington High School,15020,2,0,2
5336,2013,St Mary's Catholic College,15230,8,4,4
5337,2013,St Mary's Catholic College,15320,2,0,2
5338,2013,St Mary's Catholic College,15200,2,0,2
5339,2013,St Mary's Catholic College,15400,1,0,1
5340,2013,St Mary's Catholic College,15290,2,0,2
5341,2013,St Mary's Catholic College,15250,1,1,0
5342,2013,St Mary's Catholic College,15220,1,0,1
5343,2013,St Mary's Catholic College,15010,2,0,2
5344,2013,Holsworthy High School,15230,1,1,0
5345,2013,St Marys Senior High School,15240,5,3,2
5346,2013,St Marys Senior High School,15270,1,0,1
5347,2013,St Marys Senior High School,15340,6,3,3
5348,2013,St Marys Senior High School,15170,1,0,1
5349,2013,St Marys Senior High School,15230,16,2,14
5350,2013,St Marys Senior High School,15660,6,0,6
5351,2013,St Marys Senior High School,27199,1,0,1
5352,2013,St Marys Senior High School,15320,6,1,5
5353,2013,St Marys Senior High School,15280,1,0,1
5354,2013,St Marys Senior High School,15670,8,1,7
5355,2013,St Marys Senior High School,15350,20,2,18
5356,2013,St Marys Senior High School,16070,3,0,3
5357,2013,St Marys Senior High School,15200,1,1,0
5358,2013,St Marys Senior High School,15380,2,0,2
5359,2013,St Marys Senior High School,15820,2,1,1
5360,2013,St Marys Senior High School,15160,5,2,3
5361,2013,St Marys Senior High School,15300,2,1,1
5362,2013,St Marys Senior High School,15560,1,0,1
5363,2013,St Marys Senior High School,15260,2,1,1
5364,2013,St Marys Senior High School,15030,9,1,8
5365,2013,St Marys Senior High School,15370,1,0,1
5366,2013,St Marys Senior High School,15310,1,0,1
5367,2013,St Marys Senior High School,26599,3,1,2
5368,2013,St Marys Senior High School,15330,1,1,0
5369,2013,St Marys Senior High School,15150,2,1,1
5370,2013,St Marys Senior High School,15400,10,0,10
5371,2013,St Marys Senior High School,15100,1,0,1
5372,2013,St Marys Senior High School,15040,5,1,4
5373,2013,St Marys Senior High School,15180,5,1,4
5374,2013,St Marys Senior High School,15060,6,0,6
5375,2013,St Marys Senior High School,15140,24,2,22
5376,2013,St Marys Senior High School,15050,3,2,1
5377,2013,St Marys Senior High School,15210,3,2,1
5378,2013,St Marys Senior High School,15290,4,2,2
5379,2013,St Marys Senior High School,15250,7,3,4
5380,2013,St Marys Senior High School,15220,4,0,4
5381,2013,St Marys Senior High School,15020,2,0,2
5382,2013,St Marys Senior High School,15390,3,0,3
5383,2013,Turramurra High School,15240,24,9,15
5384,2013,Turramurra High School,15270,1,0,1
5385,2013,Turramurra High School,15340,2,1,1
5386,2013,Turramurra High School,15230,7,2,5
5387,2013,Turramurra High School,15190,1,1,0
5388,2013,Turramurra High School,15080,2,0,2
5389,2013,Turramurra High School,15120,2,2,0
5390,2013,Turramurra High School,15070,1,0,1
5391,2013,Turramurra High School,15320,2,0,2
5392,2013,Turramurra High School,15280,1,0,1
5393,2013,Turramurra High School,15350,4,0,4
5394,2013,Turramurra High School,15200,1,0,1
5395,2013,Turramurra High School,15820,4,1,3
5396,2013,Turramurra High School,15160,4,0,4
5397,2013,Turramurra High School,15710,1,0,1
5398,2013,Turramurra High School,15560,5,0,5
5399,2013,Turramurra High School,15680,1,0,1
5400,2013,Turramurra High School,15840,1,0,1
5401,2013,Turramurra High School,15260,3,1,2
5402,2013,Turramurra High School,15030,3,1,2
5403,2013,Turramurra High School,15370,3,2,1
5404,2013,Turramurra High School,26599,3,0,3
5405,2013,Turramurra High School,15330,1,1,0
5406,2013,Turramurra High School,15400,1,0,1
5407,2013,Turramurra High School,15040,1,1,0
5408,2013,Turramurra High School,15180,2,0,2
5409,2013,Turramurra High School,15060,4,0,4
5410,2013,Turramurra High School,15140,8,0,8
5411,2013,Turramurra High School,15050,3,1,2
5412,2013,Turramurra High School,15250,8,2,6
5413,2013,Turramurra High School,15220,3,1,2
5414,2013,Turramurra High School,15020,7,0,7
5415,2013,Turramurra High School,15390,1,0,1
5416,2013,Bede Polding College,15240,1,1,0
5417,2013,Bede Polding College,15270,1,1,0
5418,2013,Bede Polding College,15340,1,1,0
5419,2013,Bede Polding College,15230,2,0,2
5420,2013,Bede Polding College,15090,2,1,1
5421,2013,Bede Polding College,15320,2,0,2
5422,2013,Bede Polding College,15280,2,2,0
5423,2013,Bede Polding College,15200,3,2,1
5424,2013,Bede Polding College,15160,1,1,0
5425,2013,Bede Polding College,15370,4,2,2
5426,2013,Bede Polding College,15330,1,1,0
5427,2013,Bede Polding College,15040,1,0,1
5428,2013,Bede Polding College,15060,1,0,1
5429,2013,Bede Polding College,15140,1,0,1
5430,2013,Bede Polding College,15220,5,2,3
5431,2013,Bede Polding College,15020,4,3,1
5432,2013,Canberra Grammar School,15240,16,15,1
5433,2013,Canberra Grammar School,15270,7,7,0
5434,2013,Canberra Grammar School,15230,5,4,1
5435,2013,Canberra Grammar School,15190,2,2,0
5436,2013,Canberra Grammar School,15360,5,5,0
5437,2013,Canberra Grammar School,15550,3,3,0
5438,2013,Canberra Grammar School,15320,3,3,0
5439,2013,Canberra Grammar School,15280,6,6,0
5440,2013,Canberra Grammar School,15300,1,1,0
5441,2013,Canberra Grammar School,15110,3,1,2
5442,2013,Canberra Grammar School,15910,3,3,0
5443,2013,Canberra Grammar School,15680,6,6,0
5444,2013,Canberra Grammar School,15260,4,3,1
5445,2013,Canberra Grammar School,15570,2,2,0
5446,2013,Canberra Grammar School,15900,3,3,0
5447,2013,Canberra Grammar School,15030,4,3,1
5448,2013,Canberra Grammar School,15310,1,1,0
5449,2013,Canberra Grammar School,15330,6,5,1
5450,2013,Canberra Grammar School,15400,2,2,0
5451,2013,Canberra Grammar School,15040,2,2,0
5452,2013,Canberra Grammar School,15140,3,3,0
5453,2013,Canberra Grammar School,15050,15,13,2
5454,2013,Canberra Grammar School,15250,11,8,3
5455,2013,Canberra Grammar School,15020,4,4,0
5456,2013,Moruya High School,15240,1,1,0
5457,2013,Moruya High School,15230,6,3,3
5458,2013,Moruya High School,15320,1,0,1
5459,2013,Moruya High School,15030,2,2,0
5460,2013,Moruya High School,15100,1,1,0
5461,2013,Moruya High School,15180,1,1,0
5462,2013,Moruya High School,15390,1,0,1
5463,2013,Castle Hill High School,15240,5,2,3
5464,2013,Castle Hill High School,15270,3,2,1
5465,2013,Castle Hill High School,15170,1,0,1
5466,2013,Castle Hill High School,15230,5,2,3
5467,2013,Castle Hill High School,15190,1,0,1
5468,2013,Castle Hill High School,15080,2,1,1
5469,2013,Castle Hill High School,15830,1,0,1
5470,2013,Castle Hill High School,15720,1,0,1
5471,2013,Castle Hill High School,15850,2,0,2
5472,2013,Castle Hill High School,15320,7,3,4
5473,2013,Castle Hill High School,15670,1,1,0
5474,2013,Castle Hill High School,15200,1,1,0
5475,2013,Castle Hill High School,15820,3,2,1
5476,2013,Castle Hill High School,15160,2,1,1
5477,2013,Castle Hill High School,15110,1,1,0
5478,2013,Castle Hill High School,15710,1,0,1
5479,2013,Castle Hill High School,15560,2,1,1
5480,2013,Castle Hill High School,15680,1,0,1
5481,2013,Castle Hill High School,26699,2,2,0
5482,2013,Castle Hill High School,15260,2,2,0
5483,2013,Castle Hill High School,16040,1,0,1
5484,2013,Castle Hill High School,15310,1,0,1
5485,2013,Castle Hill High School,26599,1,0,1
5486,2013,Castle Hill High School,15330,3,2,1
5487,2013,Castle Hill High School,15150,2,1,1
5488,2013,Castle Hill High School,15400,2,1,1
5489,2013,Castle Hill High School,15040,6,1,5
5490,2013,Castle Hill High School,15180,2,1,1
5491,2013,Castle Hill High School,15060,1,0,1
5492,2013,Castle Hill High School,15140,5,1,4
5493,2013,Castle Hill High School,15050,5,3,2
5494,2013,Castle Hill High School,15210,5,5,0
5495,2013,Castle Hill High School,15290,1,1,0
5496,2013,Castle Hill High School,15250,10,7,3
5497,2013,Castle Hill High School,15220,9,3,6
5498,2013,Castle Hill High School,15020,2,1,1
5499,2013,Macarthur Anglican School,15240,1,0,1
5500,2013,Macarthur Anglican School,15270,2,1,1
5501,2013,Macarthur Anglican School,15170,2,1,1
5502,2013,Macarthur Anglican School,15230,1,0,1
5503,2013,Macarthur Anglican School,15190,4,1,3
5504,2013,Macarthur Anglican School,15360,1,1,0
5505,2013,Macarthur Anglican School,15090,2,1,1
5506,2013,Macarthur Anglican School,15320,2,0,2
5507,2013,Macarthur Anglican School,15280,1,1,0
5508,2013,Macarthur Anglican School,15350,4,0,4
5509,2013,Macarthur Anglican School,15780,3,1,2
5510,2013,Macarthur Anglican School,15310,1,1,0
5511,2013,Macarthur Anglican School,15760,4,1,3
5512,2013,Macarthur Anglican School,16100,1,1,0
5513,2013,Macarthur Anglican School,15140,7,1,6
5514,2013,Macarthur Anglican School,15210,3,3,0
5515,2013,Macarthur Anglican School,15290,3,2,1
5516,2013,Macarthur Anglican School,15250,2,0,2
5517,2013,Macarthur Anglican School,15220,1,1,0
5518,2013,Murray High School,15340,2,1,1
5519,2013,Murray High School,15230,1,0,1
5520,2013,Murray High School,15320,1,0,1
5521,2013,St Paul's International College,15240,1,0,1
5522,2013,St Paul's International College,15230,1,1,0
5523,2013,St Paul's International College,15040,1,0,1
5524,2013,The Scots School,15240,3,2,1
5525,2013,The Scots School,15230,1,0,1
5526,2013,The Scots School,15320,2,0,2
5527,2013,The Scots School,15030,3,0,3
5528,2013,The Scots School,15040,1,1,0
5529,2013,The Scots School,15050,3,2,1
5530,2013,The Scots School,15250,1,1,0
5531,2013,The Scots School,15010,1,0,1
5532,2013,James Ruse Agricultural High School,15240,56,22,34
5533,2013,James Ruse Agricultural High School,15270,11,3,8
5534,2013,James Ruse Agricultural High School,15170,1,0,1
5535,2013,James Ruse Agricultural High School,15360,13,8,5
5536,2013,James Ruse Agricultural High School,15090,9,3,6
5537,2013,James Ruse Agricultural High School,15320,2,0,2
5538,2013,James Ruse Agricultural High School,15280,1,0,1
5539,2013,James Ruse Agricultural High School,15160,50,12,38
5540,2013,James Ruse Agricultural High School,15300,4,2,2
5541,2013,James Ruse Agricultural High School,15110,20,11,9
5542,2013,James Ruse Agricultural High School,15680,3,0,3
5543,2013,James Ruse Agricultural High School,15260,82,49,33
5544,2013,James Ruse Agricultural High School,15030,37,8,29
5545,2013,James Ruse Agricultural High School,15310,5,3,2
5546,2013,James Ruse Agricultural High School,15330,63,44,19
5547,2013,James Ruse Agricultural High School,15400,4,1,3
5548,2013,James Ruse Agricultural High School,15555,2,1,1
5549,2013,James Ruse Agricultural High School,15140,107,47,60
5550,2013,James Ruse Agricultural High School,15050,96,50,46
5551,2013,James Ruse Agricultural High School,15210,9,6,3
5552,2013,James Ruse Agricultural High School,15250,128,67,61
5553,2013,James Ruse Agricultural High School,15690,1,0,1
5554,2013,James Ruse Agricultural High School,15020,2,0,2
5555,2013,James Ruse Agricultural High School,15010,37,15,22
5556,2013,St Luke's Grammar School,15240,11,9,2
5557,2013,St Luke's Grammar School,15270,5,4,1
5558,2013,St Luke's Grammar School,15340,3,3,0
5559,2013,St Luke's Grammar School,15170,3,0,3
5560,2013,St Luke's Grammar School,15230,15,9,6
5561,2013,St Luke's Grammar School,15190,1,0,1
5562,2013,St Luke's Grammar School,15080,1,0,1
5563,2013,St Luke's Grammar School,15360,1,1,0
5564,2013,St Luke's Grammar School,15320,6,1,5
5565,2013,St Luke's Grammar School,15160,1,1,0
5566,2013,St Luke's Grammar School,15300,2,2,0
5567,2013,St Luke's Grammar School,15110,3,2,1
5568,2013,St Luke's Grammar School,15560,2,0,2
5569,2013,St Luke's Grammar School,15260,1,0,1
5570,2013,St Luke's Grammar School,15030,4,3,1
5571,2013,St Luke's Grammar School,15370,1,0,1
5572,2013,St Luke's Grammar School,15310,1,1,0
5573,2013,St Luke's Grammar School,15330,3,3,0
5574,2013,St Luke's Grammar School,15400,2,1,1
5575,2013,St Luke's Grammar School,15040,7,4,3
5576,2013,St Luke's Grammar School,15140,12,8,4
5577,2013,St Luke's Grammar School,15050,4,4,0
5578,2013,St Luke's Grammar School,15250,4,3,1
5579,2013,St Luke's Grammar School,15220,2,1,1
5580,2013,St Luke's Grammar School,15020,7,5,2
5581,2013,Kildare Catholic College,15240,1,1,0
5582,2013,Kildare Catholic College,15340,1,0,1
5583,2013,Kildare Catholic College,15320,1,1,0
5584,2013,Kildare Catholic College,15350,3,1,2
5585,2013,Kildare Catholic College,15060,1,0,1
5586,2013,Kildare Catholic College,15220,2,0,2
5587,2013,Peak Hill Central School,15240,1,1,0
5588,2013,Peak Hill Central School,15200,2,2,0
5589,2013,Peak Hill Central School,15290,1,1,0
5590,2013,Cabramatta High School,15240,12,6,6
5591,2013,Cabramatta High School,15340,1,0,1
5592,2013,Cabramatta High School,15230,2,1,1
5593,2013,Cabramatta High School,15200,2,1,1
5594,2013,Cabramatta High School,15160,1,0,1
5595,2013,Cabramatta High School,16050,1,0,1
5596,2013,Cabramatta High School,15880,1,0,1
5597,2013,Cabramatta High School,15260,1,0,1
5598,2013,Cabramatta High School,16140,4,2,2
5599,2013,Cabramatta High School,15030,2,1,1
5600,2013,Cabramatta High School,26599,1,0,1
5601,2013,Cabramatta High School,15150,2,2,0
5602,2013,Cabramatta High School,15400,1,1,0
5603,2013,Cabramatta High School,15040,2,2,0
5604,2013,Cabramatta High School,15180,1,0,1
5605,2013,Cabramatta High School,15050,1,0,1
5606,2013,Cabramatta High School,15250,8,3,5
5607,2013,Cabramatta High School,15020,1,1,0
5608,2013,Cabramatta High School,15390,1,0,1
5609,2013,Sydney Institute - Sutherland College-Gymea Campus,15230,1,1,0
5610,2013,Xavier Catholic College Ballina,15240,2,1,1
5611,2013,Xavier Catholic College Ballina,15270,1,1,0
5612,2013,Xavier Catholic College Ballina,15340,3,2,1
5613,2013,Xavier Catholic College Ballina,15230,6,2,4
5614,2013,Xavier Catholic College Ballina,15090,4,2,2
5615,2013,Xavier Catholic College Ballina,15320,1,0,1
5616,2013,Xavier Catholic College Ballina,15350,1,0,1
5617,2013,Xavier Catholic College Ballina,15200,2,2,0
5618,2013,Xavier Catholic College Ballina,15380,5,2,3
5619,2013,Xavier Catholic College Ballina,15680,1,0,1
5620,2013,Xavier Catholic College Ballina,15030,1,0,1
5621,2013,Xavier Catholic College Ballina,15370,5,1,4
5622,2013,Xavier Catholic College Ballina,15400,3,0,3
5623,2013,Xavier Catholic College Ballina,15040,3,2,1
5624,2013,Xavier Catholic College Ballina,15140,3,0,3
5625,2013,Xavier Catholic College Ballina,15220,3,0,3
5626,2013,Fort Street High School,15240,49,30,19
5627,2013,Fort Street High School,15270,10,8,2
5628,2013,Fort Street High School,15170,5,2,3
5629,2013,Fort Street High School,15190,3,3,0
5630,2013,Fort Street High School,15830,2,1,1
5631,2013,Fort Street High School,15120,1,1,0
5632,2013,Fort Street High School,15720,1,0,1
5633,2013,Fort Street High School,15360,2,2,0
5634,2013,Fort Street High School,15090,4,2,2
5635,2013,Fort Street High School,15550,5,1,4
5636,2013,Fort Street High School,15320,2,1,1
5637,2013,Fort Street High School,15280,3,2,1
5638,2013,Fort Street High School,15160,9,4,5
5639,2013,Fort Street High School,15300,9,4,5
5640,2013,Fort Street High School,15110,16,13,3
5641,2013,Fort Street High School,15710,2,1,1
5642,2013,Fort Street High School,15680,4,2,2
5643,2013,Fort Street High School,15260,27,19,8
5644,2013,Fort Street High School,15570,1,0,1
5645,2013,Fort Street High School,15030,7,3,4
5646,2013,Fort Street High School,15310,5,1,4
5647,2013,Fort Street High School,15330,19,16,3
5648,2013,Fort Street High School,15400,1,0,1
5649,2013,Fort Street High School,15555,4,1,3
5650,2013,Fort Street High School,15040,13,4,9
5651,2013,Fort Street High School,15140,26,11,15
5652,2013,Fort Street High School,15050,35,21,14
5653,2013,Fort Street High School,15210,3,3,0
5654,2013,Fort Street High School,15250,58,41,17
5655,2013,Fort Street High School,15220,16,10,6
5656,2013,Fort Street High School,15020,1,0,1
5657,2013,Emmaus Catholic College,16080,1,0,1
5658,2013,Emmaus Catholic College,15200,1,1,0
5659,2013,Emmaus Catholic College,16090,1,0,1
5660,2013,Emmaus Catholic College,26699,1,1,0
5661,2013,Emmaus Catholic College,15030,1,1,0
5662,2013,Emmaus Catholic College,15370,2,2,0
5663,2013,Emmaus Catholic College,26599,1,0,1
5664,2013,Emmaus Catholic College,15400,1,0,1
5665,2013,Emmaus Catholic College,15040,1,1,0
5666,2013,Emmaus Catholic College,15060,3,0,3
5667,2013,Emmaus Catholic College,15290,1,1,0
5668,2013,"MacKillop College, Bathurst",15270,4,0,4
5669,2013,"MacKillop College, Bathurst",15340,3,0,3
5670,2013,"MacKillop College, Bathurst",15230,1,0,1
5671,2013,"MacKillop College, Bathurst",15280,1,0,1
5672,2013,"MacKillop College, Bathurst",15380,2,0,2
5673,2013,"MacKillop College, Bathurst",15370,6,0,6
5674,2013,"MacKillop College, Bathurst",26599,2,0,2
5675,2013,"MacKillop College, Bathurst",15400,1,0,1
5676,2013,"MacKillop College, Bathurst",15060,3,0,3
5677,2013,"MacKillop College, Bathurst",15140,2,0,2
5678,2013,"MacKillop College, Bathurst",15220,3,0,3
5679,2013,"MacKillop College, Bathurst",15020,5,0,5
5680,2013,Sylvania High School,15240,2,2,0
5681,2013,Sylvania High School,15270,2,1,1
5682,2013,Sylvania High School,15170,2,0,2
5683,2013,Sylvania High School,15070,1,0,1
5684,2013,Sylvania High School,15400,2,0,2
5685,2013,Sylvania High School,15040,3,1,2
5686,2013,Sylvania High School,15060,2,0,2
5687,2013,Sylvania High School,15140,2,1,1
5688,2013,Sylvania High School,15050,1,1,0
5689,2013,Sylvania High School,15290,1,1,0
5690,2013,Sylvania High School,15250,1,1,0
5691,2013,Sylvania High School,15220,2,0,2
5692,2013,Sylvania High School,15020,2,0,2
5693,2013,Gilgandra High School,15240,1,0,1
5694,2013,Gilgandra High School,15190,2,0,2
5695,2013,Gilgandra High School,15090,1,1,0
5696,2013,Gilgandra High School,15680,1,0,1
5697,2013,Gilgandra High School,15030,2,0,2
5698,2013,Gilgandra High School,26599,1,0,1
5699,2013,Gilgandra High School,15330,2,0,2
5700,2013,Gilgandra High School,15060,2,1,1
5701,2013,Gilgandra High School,15010,1,0,1
5702,2013,Our Lady of Lebanon College,15240,1,1,0
5703,2013,Our Lady of Lebanon College,15340,1,1,0
5704,2013,Our Lady of Lebanon College,15370,2,1,1
5705,2013,Our Lady of Lebanon College,15060,1,0,1
5706,2013,Our Lady of Lebanon College,15250,1,1,0
5707,2013,Our Lady of Lebanon College,15390,1,0,1
5708,2013,Hunter Christian School,26999,1,1,0
5709,2013,Hunter Christian School,15260,1,1,0
5710,2013,Hunter Christian School,15290,1,1,0
5711,2013,Hunter Christian School,15250,1,1,0
5712,2013,St Joseph's College,15240,24,23,1
5713,2013,St Joseph's College,15270,2,2,0
5714,2013,St Joseph's College,15340,4,2,2
5715,2013,St Joseph's College,15170,1,0,1
5716,2013,St Joseph's College,15230,15,12,3
5717,2013,St Joseph's College,15190,6,6,0
5718,2013,St Joseph's College,15090,4,2,2
5719,2013,St Joseph's College,15320,6,3,3
5720,2013,St Joseph's College,15280,3,3,0
5721,2013,St Joseph's College,15200,3,3,0
5722,2013,St Joseph's College,15380,7,4,3
5723,2013,St Joseph's College,15160,3,1,2
5724,2013,St Joseph's College,15110,2,2,0
5725,2013,St Joseph's College,15910,2,2,0
5726,2013,St Joseph's College,15260,3,3,0
5727,2013,St Joseph's College,15900,1,1,0
5728,2013,St Joseph's College,15030,7,7,0
5729,2013,St Joseph's College,15370,28,27,1
5730,2013,St Joseph's College,15330,8,8,0
5731,2013,St Joseph's College,15400,7,5,2
5732,2013,St Joseph's College,15040,4,4,0
5733,2013,St Joseph's College,15060,2,0,2
5734,2013,St Joseph's College,15140,9,7,2
5735,2013,St Joseph's College,15130,1,0,1
5736,2013,St Joseph's College,15050,6,6,0
5737,2013,St Joseph's College,15210,1,1,0
5738,2013,St Joseph's College,15290,1,1,0
5739,2013,St Joseph's College,15250,17,16,1
5740,2013,St Joseph's College,15220,9,9,0
5741,2013,St Joseph's College,15020,9,9,0
5742,2013,Bega High School,15230,1,1,0
5743,2013,Bega High School,15160,2,0,2
5744,2013,Bega High School,15030,3,0,3
5745,2013,Bega High School,15220,1,0,1
5746,2013,Bega High School,15020,2,0,2
5747,2013,Kempsey High School,15400,1,1,0
5748,2013,James Fallon High School,26999,1,0,1
5749,2013,James Fallon High School,15090,1,0,1
5750,2013,James Fallon High School,15290,1,1,0
5751,2013,Quirindi High School,15030,1,0,1
5752,2013,Ambarvale High School,15280,1,0,1
5753,2013,Ambarvale High School,15160,1,0,1
5754,2013,Ambarvale High School,15140,1,0,1
5755,2013,Ambarvale High School,15220,1,0,1
5756,2013,Alpha Omega Senior College,15240,6,4,2
5757,2013,Alpha Omega Senior College,15380,1,0,1
5758,2013,Alpha Omega Senior College,15260,1,1,0
5759,2013,Alpha Omega Senior College,15030,5,3,2
5760,2013,Alpha Omega Senior College,15330,1,1,0
5761,2013,Alpha Omega Senior College,15040,4,1,3
5762,2013,Alpha Omega Senior College,15140,1,0,1
5763,2013,Alpha Omega Senior College,15050,1,1,0
5764,2013,Alpha Omega Senior College,15250,3,3,0
5765,2013,Alpha Omega Senior College,15220,1,0,1
5766,2013,Alpha Omega Senior College,15020,1,0,1
5767,2013,St Joseph's Catholic College,15240,1,0,1
5768,2013,St Joseph's Catholic College,15270,3,0,3
5769,2013,St Joseph's Catholic College,15340,2,0,2
5770,2013,St Joseph's Catholic College,15230,6,0,6
5771,2013,St Joseph's Catholic College,15320,2,0,2
5772,2013,St Joseph's Catholic College,15280,1,0,1
5773,2013,St Joseph's Catholic College,15380,1,0,1
5774,2013,St Joseph's Catholic College,15160,2,0,2
5775,2013,St Joseph's Catholic College,15030,1,0,1
5776,2013,St Joseph's Catholic College,15370,8,0,8
5777,2013,St Joseph's Catholic College,15180,2,0,2
5778,2013,St Joseph's Catholic College,15060,1,0,1
5779,2013,St Joseph's Catholic College,15250,1,0,1
5780,2013,St Joseph's Catholic College,15220,4,0,4
5781,2013,St Joseph's Catholic College,15020,1,0,1
5782,2013,Macquarie Anglican Grammar School,15020,1,0,1
5783,2013,Kooringal High School,15340,1,0,1
5784,2013,Kooringal High School,15230,1,0,1
5785,2013,Kooringal High School,15360,1,1,0
5786,2013,Kooringal High School,15160,1,0,1
5787,2013,Kooringal High School,15400,1,0,1
5788,2013,Kooringal High School,15290,2,1,1
5789,2013,Pittwater House Schools,15240,4,2,2
5790,2013,Pittwater House Schools,15230,3,0,3
5791,2013,Pittwater House Schools,15190,1,1,0
5792,2013,Pittwater House Schools,15560,1,0,1
5793,2013,Pittwater House Schools,15260,1,1,0
5794,2013,Pittwater House Schools,15310,1,0,1
5795,2013,Pittwater House Schools,15330,2,2,0
5796,2013,Pittwater House Schools,15400,2,0,2
5797,2013,Pittwater House Schools,15040,1,1,0
5798,2013,Pittwater House Schools,15800,1,0,1
5799,2013,Pittwater House Schools,15140,1,1,0
5800,2013,Pittwater House Schools,15050,1,1,0
5801,2013,Pittwater House Schools,15290,1,1,0
5802,2013,Pittwater House Schools,15250,2,2,0
5803,2013,Pittwater House Schools,15220,2,1,1
5804,2013,Goulburn High School,15200,1,1,0
5805,2013,Goulburn High School,15290,1,1,0
5806,2013,Tumbarumba High School,15200,2,2,0
5807,2013,Tumbarumba High School,26599,2,1,1
5808,2013,Molong Central School,15170,1,1,0
5809,2013,Molong Central School,15090,1,1,0
5810,2013,Molong Central School,26599,1,0,1
5811,2013,Molong Central School,15390,1,0,1
5812,2013,Monaro High School,15240,1,0,1
5813,2013,Monaro High School,15170,2,0,2
5814,2013,Monaro High School,15120,1,1,0
5815,2013,Monaro High School,15090,3,1,2
5816,2013,Monaro High School,15320,2,0,2
5817,2013,Monaro High School,15350,1,0,1
5818,2013,Monaro High School,15060,2,0,2
5819,2013,Monaro High School,15140,1,0,1
5820,2013,Monaro High School,15290,1,0,1
5821,2013,Monaro High School,15020,3,1,2
5822,2013,Northern Beaches Christian School,15240,5,5,0
5823,2013,Northern Beaches Christian School,15230,11,9,2
5824,2013,Northern Beaches Christian School,15360,2,2,0
5825,2013,Northern Beaches Christian School,15090,3,1,2
5826,2013,Northern Beaches Christian School,15280,1,1,0
5827,2013,Northern Beaches Christian School,26299,1,1,0
5828,2013,Northern Beaches Christian School,15380,2,1,1
5829,2013,Northern Beaches Christian School,15110,1,1,0
5830,2013,Northern Beaches Christian School,15030,4,3,1
5831,2013,Northern Beaches Christian School,15400,2,2,0
5832,2013,Northern Beaches Christian School,15140,2,1,1
5833,2013,Northern Beaches Christian School,15050,2,2,0
5834,2013,Northern Beaches Christian School,15290,3,3,0
5835,2013,Northern Beaches Christian School,15250,2,2,0
5836,2013,Northern Beaches Christian School,15020,1,0,1
5837,2013,Pymble Ladies' College,15240,35,2,33
5838,2013,Pymble Ladies' College,15270,32,1,31
5839,2013,Pymble Ladies' College,15340,10,3,7
5840,2013,Pymble Ladies' College,15170,6,1,5
5841,2013,Pymble Ladies' College,15230,20,1,19
5842,2013,Pymble Ladies' College,15190,11,0,11
5843,2013,Pymble Ladies' College,15830,6,0,6
5844,2013,Pymble Ladies' College,15090,11,0,11
5845,2013,Pymble Ladies' College,15850,4,0,4
5846,2013,Pymble Ladies' College,15550,3,0,3
5847,2013,Pymble Ladies' College,15320,2,0,2
5848,2013,Pymble Ladies' College,15280,21,0,21
5849,2013,Pymble Ladies' College,15590,5,1,4
5850,2013,Pymble Ladies' College,15160,39,2,37
5851,2013,Pymble Ladies' College,15300,11,1,10
5852,2013,Pymble Ladies' College,15580,5,1,4
5853,2013,Pymble Ladies' College,15110,5,0,5
5854,2013,Pymble Ladies' College,15910,8,1,7
5855,2013,Pymble Ladies' College,15710,2,0,2
5856,2013,Pymble Ladies' College,15560,2,0,2
5857,2013,Pymble Ladies' College,15680,7,1,6
5858,2013,Pymble Ladies' College,15260,8,0,8
5859,2013,Pymble Ladies' College,15570,1,0,1
5860,2013,Pymble Ladies' College,15000,1,0,1
5861,2013,Pymble Ladies' College,15900,8,1,7
5862,2013,Pymble Ladies' College,15030,32,2,30
5863,2013,Pymble Ladies' College,15790,8,1,7
5864,2013,Pymble Ladies' College,15310,10,1,9
5865,2013,Pymble Ladies' College,26599,3,0,3
5866,2013,Pymble Ladies' College,15330,6,0,6
5867,2013,Pymble Ladies' College,15150,2,0,2
5868,2013,Pymble Ladies' College,15400,30,0,30
5869,2013,Pymble Ladies' College,15100,3,0,3
5870,2013,Pymble Ladies' College,15040,22,1,21
5871,2013,Pymble Ladies' College,15800,1,0,1
5872,2013,Pymble Ladies' College,15180,9,0,9
5873,2013,Pymble Ladies' College,15140,97,2,95
5874,2013,Pymble Ladies' College,15050,18,1,17
5875,2013,Pymble Ladies' College,15290,3,1,2
5876,2013,Pymble Ladies' College,15250,34,1,33
5877,2013,Pymble Ladies' College,15690,5,2,3
5878,2013,Pymble Ladies' College,15220,15,0,15
5879,2013,Pymble Ladies' College,15020,13,0,13
5880,2013,Pymble Ladies' College,15390,6,0,6
5881,2013,Pymble Ladies' College,15010,5,1,4
5882,2013,Springwood High School,15240,4,3,1
5883,2013,Springwood High School,15270,1,1,0
5884,2013,Springwood High School,15170,1,0,1
5885,2013,Springwood High School,15230,3,2,1
5886,2013,Springwood High School,15090,3,1,2
5887,2013,Springwood High School,15320,4,1,3
5888,2013,Springwood High School,15670,1,1,0
5889,2013,Springwood High School,15350,3,2,1
5890,2013,Springwood High School,16070,1,0,1
5891,2013,Springwood High School,15380,2,1,1
5892,2013,Springwood High School,15030,1,1,0
5893,2013,Springwood High School,26599,1,1,0
5894,2013,Springwood High School,15400,3,0,3
5895,2013,Springwood High School,15100,1,1,0
5896,2013,Springwood High School,15040,3,1,2
5897,2013,Springwood High School,15140,2,0,2
5898,2013,Springwood High School,15050,1,1,0
5899,2013,Springwood High School,15210,1,1,0
5900,2013,Springwood High School,15290,2,2,0
5901,2013,Springwood High School,15220,2,1,1
5902,2013,Springwood High School,15020,2,0,2
5903,2013,Tomaree High School,15340,1,0,1
5904,2013,Tomaree High School,15230,1,0,1
5905,2013,Tomaree High School,15090,1,0,1
5906,2013,Tomaree High School,15320,1,0,1
5907,2013,Tomaree High School,15670,1,0,1
5908,2013,Tomaree High School,26599,1,0,1
5909,2013,Tomaree High School,15400,1,0,1
5910,2013,Tomaree High School,15180,2,0,2
5911,2013,Tomaree High School,15290,1,0,1
5912,2013,Orange Christian School,15270,2,1,1
5913,2013,Orange Christian School,15060,2,1,1
5914,2013,Orange Christian School,15290,1,1,0
5915,2013,South Sydney High School,15240,1,1,0
5916,2013,South Sydney High School,15230,2,1,1
5917,2013,South Sydney High School,15120,1,1,0
5918,2013,South Sydney High School,15090,1,0,1
5919,2013,South Sydney High School,15110,2,1,1
5920,2013,South Sydney High School,15680,2,2,0
5921,2013,South Sydney High School,16020,1,0,1
5922,2013,South Sydney High School,15310,1,1,0
5923,2013,South Sydney High School,15040,1,0,1
5924,2013,South Sydney High School,15140,1,0,1
5925,2013,South Sydney High School,15290,1,0,1
5926,2013,South Sydney High School,15250,1,1,0
5927,2013,South Sydney High School,15690,1,1,0
5928,2013,Rose Bay Secondary College,15240,4,4,0
5929,2013,Rose Bay Secondary College,15230,2,2,0
5930,2013,Rose Bay Secondary College,15120,2,2,0
5931,2013,Rose Bay Secondary College,16000,1,1,0
5932,2013,Rose Bay Secondary College,15350,3,0,3
5933,2013,Rose Bay Secondary College,16070,1,1,0
5934,2013,Rose Bay Secondary College,15300,3,0,3
5935,2013,Rose Bay Secondary College,15710,1,0,1
5936,2013,Rose Bay Secondary College,15260,1,1,0
5937,2013,Rose Bay Secondary College,15310,3,1,2
5938,2013,Rose Bay Secondary College,15330,1,1,0
5939,2013,Rose Bay Secondary College,15040,1,0,1
5940,2013,Rose Bay Secondary College,15140,3,2,1
5941,2013,Rose Bay Secondary College,15050,1,1,0
5942,2013,Rose Bay Secondary College,15210,1,1,0
5943,2013,Rose Bay Secondary College,15250,3,2,1
5944,2013,Rose Bay Secondary College,15220,1,1,0
5945,2013,Rose Bay Secondary College,15020,2,1,1
5946,2013,Glen Innes High School,15270,1,0,1
5947,2013,Glen Innes High School,15170,1,0,1
5948,2013,Glen Innes High School,15260,1,1,0
5949,2013,Glen Innes High School,15290,1,0,1
5950,2013,Glen Innes High School,15250,1,1,0
5951,2013,Glen Innes High School,15020,2,0,2
5952,2013,Ashcroft High School,15080,1,1,0
5953,2013,Ashcroft High School,15030,1,1,0
5954,2013,Ashcroft High School,15250,1,1,0
5955,2013,INTI International College Penang,15240,7,2,5
5956,2013,INTI International College Penang,15030,1,0,1
5957,2013,INTI International College Penang,15330,1,0,1
5958,2013,INTI International College Penang,15050,3,1,2
5959,2013,INTI International College Penang,15250,5,1,4
5960,2013,Australian Islamic College of Sydney,15350,1,0,1
5961,2013,Australian Islamic College of Sydney,15380,1,0,1
5962,2013,Australian Islamic College of Sydney,15220,1,0,1
5963,2013,Liverpool Girls High School,15240,3,0,3
5964,2013,Liverpool Girls High School,15270,3,1,2
5965,2013,Liverpool Girls High School,15230,2,0,2
5966,2013,Liverpool Girls High School,15670,1,0,1
5967,2013,Liverpool Girls High School,15350,4,0,4
5968,2013,Liverpool Girls High School,16070,3,0,3
5969,2013,Liverpool Girls High School,15380,1,0,1
5970,2013,Liverpool Girls High School,15940,1,0,1
5971,2013,Liverpool Girls High School,16050,2,0,2
5972,2013,Liverpool Girls High School,15260,2,1,1
5973,2013,Liverpool Girls High School,15510,2,0,2
5974,2013,Liverpool Girls High School,15040,1,0,1
5975,2013,Liverpool Girls High School,15520,1,0,1
5976,2013,Liverpool Girls High School,15140,1,1,0
5977,2013,Liverpool Girls High School,15050,2,1,1
5978,2013,Liverpool Girls High School,15250,3,1,2
5979,2013,Liverpool Girls High School,15220,10,2,8
5980,2013,Liverpool Girls High School,15020,3,0,3
5981,2013,Bulahdelah Central School,15030,1,0,1
5982,2013,Bulahdelah Central School,15040,1,0,1
5983,2013,Sydney Institute - Randwick College,15140,1,0,1
5984,2013,Birrong Girls High School,15270,1,0,1
5985,2013,Birrong Girls High School,26999,1,0,1
5986,2013,Birrong Girls High School,15230,2,0,2
5987,2013,Birrong Girls High School,15090,2,0,2
5988,2013,Birrong Girls High School,15350,2,0,2
5989,2013,Birrong Girls High School,15380,1,0,1
5990,2013,Birrong Girls High School,15160,1,0,1
5991,2013,Birrong Girls High School,15560,1,0,1
5992,2013,Birrong Girls High School,15030,1,0,1
5993,2013,Birrong Girls High School,15370,1,0,1
5994,2013,Birrong Girls High School,26599,2,0,2
5995,2013,Birrong Girls High School,15400,1,0,1
5996,2013,Birrong Girls High School,15555,1,0,1
5997,2013,Birrong Girls High School,15040,2,0,2
5998,2013,Birrong Girls High School,15180,2,0,2
5999,2013,Birrong Girls High School,15060,2,0,2
6000,2013,Birrong Girls High School,15140,5,0,5
6001,2013,Birrong Girls High School,15130,2,0,2
6002,2013,Birrong Girls High School,15220,1,0,1
6003,2013,Bulli High School,15240,2,1,1
6004,2013,Bulli High School,15270,4,1,3
6005,2013,Bulli High School,15340,6,2,4
6006,2013,Bulli High School,15230,1,0,1
6007,2013,Bulli High School,15080,1,0,1
6008,2013,Bulli High School,15350,1,0,1
6009,2013,Bulli High School,15820,1,0,1
6010,2013,Bulli High School,15560,1,1,0
6011,2013,Bulli High School,15790,1,0,1
6012,2013,Bulli High School,15400,3,0,3
6013,2013,Bulli High School,15100,2,1,1
6014,2013,Bulli High School,15050,1,1,0
6015,2013,Bulli High School,15290,1,0,1
6016,2013,Bulli High School,15250,2,2,0
6017,2013,Bulli High School,15020,5,1,4
6018,2013,Lismore High School,15240,1,1,0
6019,2013,Lismore High School,15330,1,1,0
6020,2013,Lismore High School,15140,1,1,0
6021,2013,Lismore High School,15050,1,1,0
6022,2013,Lismore High School,15250,1,1,0
6023,2013,Canowindra High School,15340,3,1,2
6024,2013,Canowindra High School,15010,1,1,0
6025,2013,Green Point Christian College,15340,1,0,1
6026,2013,Green Point Christian College,26999,1,0,1
6027,2013,Green Point Christian College,15090,3,1,2
6028,2013,Green Point Christian College,15670,2,1,1
6029,2013,Green Point Christian College,16070,1,0,1
6030,2013,Green Point Christian College,27099,1,1,0
6031,2013,Green Point Christian College,15030,1,0,1
6032,2013,Green Point Christian College,15400,1,0,1
6033,2013,Green Point Christian College,15060,1,0,1
6034,2013,Green Point Christian College,15290,9,5,4
6035,2013,Green Point Christian College,15250,1,1,0
6036,2013,Green Point Christian College,15220,1,0,1
6037,2013,Green Point Christian College,15020,2,0,2
6038,2013,St Pius X College,15240,16,15,1
6039,2013,St Pius X College,15270,12,12,0
6040,2013,St Pius X College,15170,2,2,0
6041,2013,St Pius X College,15230,9,9,0
6042,2013,St Pius X College,15320,5,5,0
6043,2013,St Pius X College,15280,5,5,0
6044,2013,St Pius X College,15200,3,3,0
6045,2013,St Pius X College,15380,3,3,0
6046,2013,St Pius X College,15160,6,6,0
6047,2013,St Pius X College,15300,1,1,0
6048,2013,St Pius X College,15110,2,2,0
6049,2013,St Pius X College,15260,5,4,1
6050,2013,St Pius X College,15370,13,13,0
6051,2013,St Pius X College,15330,5,5,0
6052,2013,St Pius X College,15400,2,2,0
6053,2013,St Pius X College,15040,7,7,0
6054,2013,St Pius X College,15140,10,10,0
6055,2013,St Pius X College,15050,2,2,0
6056,2013,St Pius X College,15210,2,2,0
6057,2013,St Pius X College,15250,15,13,2
6058,2013,St Pius X College,15220,5,5,0
6059,2013,St Pius X College,15020,10,10,0
6060,2013,Moss Vale High School,15240,1,1,0
6061,2013,Moss Vale High School,15270,1,0,1
6062,2013,Moss Vale High School,26699,1,0,1
6063,2013,Moss Vale High School,15290,3,2,1
6064,2013,Moss Vale High School,15250,1,1,0
6065,2013,Moss Vale High School,15690,1,0,1
6066,2013,Moss Vale High School,15020,3,1,2
6067,2013,Moss Vale High School,15700,2,1,1
6068,2013,St Catherine's School,15240,6,0,6
6069,2013,St Catherine's School,15270,4,1,3
6070,2013,St Catherine's School,15170,2,0,2
6071,2013,St Catherine's School,15230,3,0,3
6072,2013,St Catherine's School,15080,5,0,5
6073,2013,St Catherine's School,15070,1,0,1
6074,2013,St Catherine's School,15090,1,0,1
6075,2013,St Catherine's School,15320,3,0,3
6076,2013,St Catherine's School,15280,2,0,2
6077,2013,St Catherine's School,15380,2,0,2
6078,2013,St Catherine's School,15820,1,0,1
6079,2013,St Catherine's School,15160,4,0,4
6080,2013,St Catherine's School,15300,2,1,1
6081,2013,St Catherine's School,15110,2,0,2
6082,2013,St Catherine's School,15680,8,1,7
6083,2013,St Catherine's School,15260,5,2,3
6084,2013,St Catherine's School,15030,3,0,3
6085,2013,St Catherine's School,15790,1,0,1
6086,2013,St Catherine's School,15310,2,0,2
6087,2013,St Catherine's School,15330,3,0,3
6088,2013,St Catherine's School,15150,1,0,1
6089,2013,St Catherine's School,15400,13,2,11
6090,2013,St Catherine's School,15040,9,0,9
6091,2013,St Catherine's School,15140,19,2,17
6092,2013,St Catherine's School,15050,4,1,3
6093,2013,St Catherine's School,15290,2,0,2
6094,2013,St Catherine's School,15250,12,2,10
6095,2013,St Catherine's School,15690,2,0,2
6096,2013,St Catherine's School,15220,9,0,9
6097,2013,St Catherine's School,15020,2,0,2
6098,2013,Our Lady of Mercy College Parramatta,15240,5,0,5
6099,2013,Our Lady of Mercy College Parramatta,15270,1,0,1
6100,2013,Our Lady of Mercy College Parramatta,15340,2,0,2
6101,2013,Our Lady of Mercy College Parramatta,26999,3,0,3
6102,2013,Our Lady of Mercy College Parramatta,15170,3,0,3
6103,2013,Our Lady of Mercy College Parramatta,15230,6,0,6
6104,2013,Our Lady of Mercy College Parramatta,15190,4,0,4
6105,2013,Our Lady of Mercy College Parramatta,15080,2,0,2
6106,2013,Our Lady of Mercy College Parramatta,15090,6,0,6
6107,2013,Our Lady of Mercy College Parramatta,15320,4,0,4
6108,2013,Our Lady of Mercy College Parramatta,15350,2,0,2
6109,2013,Our Lady of Mercy College Parramatta,15380,7,0,7
6110,2013,Our Lady of Mercy College Parramatta,15160,9,0,9
6111,2013,Our Lady of Mercy College Parramatta,16020,1,0,1
6112,2013,Our Lady of Mercy College Parramatta,15260,2,0,2
6113,2013,Our Lady of Mercy College Parramatta,15030,4,0,4
6114,2013,Our Lady of Mercy College Parramatta,15370,16,0,16
6115,2013,Our Lady of Mercy College Parramatta,26599,1,0,1
6116,2013,Our Lady of Mercy College Parramatta,15400,5,0,5
6117,2013,Our Lady of Mercy College Parramatta,15100,1,0,1
6118,2013,Our Lady of Mercy College Parramatta,15040,8,0,8
6119,2013,Our Lady of Mercy College Parramatta,15060,4,0,4
6120,2013,Our Lady of Mercy College Parramatta,15140,22,0,22
6121,2013,Our Lady of Mercy College Parramatta,15130,2,0,2
6122,2013,Our Lady of Mercy College Parramatta,15050,3,0,3
6123,2013,Our Lady of Mercy College Parramatta,15290,1,0,1
6124,2013,Our Lady of Mercy College Parramatta,15250,9,0,9
6125,2013,Our Lady of Mercy College Parramatta,15220,5,0,5
6126,2013,Our Lady of Mercy College Parramatta,15020,3,0,3
6127,2013,St Augustine's College Sydney,15240,9,9,0
6128,2013,St Augustine's College Sydney,15270,5,5,0
6129,2013,St Augustine's College Sydney,15340,2,1,1
6130,2013,St Augustine's College Sydney,15230,10,10,0
6131,2013,St Augustine's College Sydney,15190,2,2,0
6132,2013,St Augustine's College Sydney,15080,3,3,0
6133,2013,St Augustine's College Sydney,15120,1,1,0
6134,2013,St Augustine's College Sydney,15320,3,3,0
6135,2013,St Augustine's College Sydney,15200,2,2,0
6136,2013,St Augustine's College Sydney,15820,1,1,0
6137,2013,St Augustine's College Sydney,15110,1,1,0
6138,2013,St Augustine's College Sydney,15260,1,0,1
6139,2013,St Augustine's College Sydney,15030,3,3,0
6140,2013,St Augustine's College Sydney,15370,7,7,0
6141,2013,St Augustine's College Sydney,15330,1,1,0
6142,2013,St Augustine's College Sydney,15400,1,1,0
6143,2013,St Augustine's College Sydney,15040,3,3,0
6144,2013,St Augustine's College Sydney,15140,2,2,0
6145,2013,St Augustine's College Sydney,15130,1,1,0
6146,2013,St Augustine's College Sydney,15050,1,1,0
6147,2013,St Augustine's College Sydney,15250,9,8,1
6148,2013,St Augustine's College Sydney,15220,2,2,0
6149,2013,St Augustine's College Sydney,15020,1,1,0
6150,2013,Kellyville High School,15270,2,2,0
6151,2013,Kellyville High School,15230,3,1,2
6152,2013,Kellyville High School,15320,3,2,1
6153,2013,Kellyville High School,15350,2,1,1
6154,2013,Kellyville High School,15200,3,3,0
6155,2013,Kellyville High School,15030,4,3,1
6156,2013,Kellyville High School,15040,3,3,0
6157,2013,Kellyville High School,15180,1,0,1
6158,2013,Kellyville High School,15060,1,0,1
6159,2013,Kellyville High School,15140,1,0,1
6160,2013,Kellyville High School,15250,1,1,0
6161,2013,Kellyville High School,15220,7,4,3
6162,2013,Denison College of Secondary Education Bathurst High Campus,15170,1,1,0
6163,2013,Denison College of Secondary Education Bathurst High Campus,15230,2,1,1
6164,2013,Denison College of Secondary Education Bathurst High Campus,15160,2,1,1
6165,2013,Denison College of Secondary Education Bathurst High Campus,15110,1,0,1
6166,2013,Denison College of Secondary Education Bathurst High Campus,15030,1,0,1
6167,2013,Denison College of Secondary Education Bathurst High Campus,26599,1,0,1
6168,2013,Denison College of Secondary Education Bathurst High Campus,15400,1,0,1
6169,2013,Denison College of Secondary Education Bathurst High Campus,15290,1,1,0
6170,2013,Denison College of Secondary Education Bathurst High Campus,15020,1,1,0
6171,2013,J J Cahill Memorial High School,15200,1,1,0
6172,2013,J J Cahill Memorial High School,16050,1,0,1
6173,2013,J J Cahill Memorial High School,15030,1,1,0
6174,2013,Taylors College,15240,2,0,2
6175,2013,Taylors College,15820,2,0,2
6176,2013,Taylors College,15560,5,0,5
6177,2013,Taylors College,15250,1,0,1
6178,2013,Westfields Sports High School,15240,9,7,2
6179,2013,Westfields Sports High School,26999,1,0,1
6180,2013,Westfields Sports High School,15230,2,1,1
6181,2013,Westfields Sports High School,15070,4,0,4
6182,2013,Westfields Sports High School,16080,3,0,3
6183,2013,Westfields Sports High School,15320,3,0,3
6184,2013,Westfields Sports High School,15350,3,0,3
6185,2013,Westfields Sports High School,15200,3,2,1
6186,2013,Westfields Sports High School,15110,1,0,1
6187,2013,Westfields Sports High School,15260,1,1,0
6188,2013,Westfields Sports High School,26599,2,0,2
6189,2013,Westfields Sports High School,15400,2,0,2
6190,2013,Westfields Sports High School,15040,3,0,3
6191,2013,Westfields Sports High School,15060,2,0,2
6192,2013,Westfields Sports High School,15050,3,3,0
6193,2013,Westfields Sports High School,15250,9,8,1
6194,2013,Westfields Sports High School,15220,1,0,1
6195,2013,Westfields Sports High School,15020,6,1,5
6196,2013,Macintyre High School,15240,1,1,0
6197,2013,Macintyre High School,26899,1,0,1
6198,2013,Macintyre High School,15670,1,1,0
6199,2013,Macintyre High School,15200,1,0,1
6200,2013,Macintyre High School,15330,1,1,0
6201,2013,Macintyre High School,15050,1,1,0
6202,2013,Macintyre High School,15290,1,1,0
6203,2013,Ascham School,15240,15,1,14
6204,2013,Ascham School,15270,11,0,11
6205,2013,Ascham School,15170,4,0,4
6206,2013,Ascham School,15230,6,0,6
6207,2013,Ascham School,15190,1,0,1
6208,2013,Ascham School,15720,2,0,2
6209,2013,Ascham School,15090,11,0,11
6210,2013,Ascham School,15280,5,0,5
6211,2013,Ascham School,15160,13,0,13
6212,2013,Ascham School,15300,4,0,4
6213,2013,Ascham School,15110,8,0,8
6214,2013,Ascham School,15710,7,1,6
6215,2013,Ascham School,15680,9,0,9
6216,2013,Ascham School,15260,6,0,6
6217,2013,Ascham School,15980,1,0,1
6218,2013,Ascham School,15900,1,0,1
6219,2013,Ascham School,15030,4,1,3
6220,2013,Ascham School,15310,3,0,3
6221,2013,Ascham School,15330,4,0,4
6222,2013,Ascham School,15400,26,0,26
6223,2013,Ascham School,15140,33,1,32
6224,2013,Ascham School,15130,1,0,1
6225,2013,Ascham School,15050,8,0,8
6226,2013,Ascham School,15250,13,1,12
6227,2013,Ascham School,15690,2,0,2
6228,2013,Ascham School,15020,5,0,5
6229,2013,Kingscliff High School,15240,1,1,0
6230,2013,Kingscliff High School,15320,1,0,1
6231,2013,Kingscliff High School,15110,1,0,1
6232,2013,Kingscliff High School,26599,1,0,1
6233,2013,Kingscliff High School,15330,1,1,0
6234,2013,Kingscliff High School,15100,1,0,1
6235,2013,Kingscliff High School,15040,1,0,1
6236,2013,Kingscliff High School,15140,2,0,2
6237,2013,Kingscliff High School,15290,2,0,2
6238,2013,Kingscliff High School,15250,1,0,1
6239,2013,Catherine McAuley Westmead,15240,5,0,5
6240,2013,Catherine McAuley Westmead,15270,5,0,5
6241,2013,Catherine McAuley Westmead,15170,1,0,1
6242,2013,Catherine McAuley Westmead,15230,3,0,3
6243,2013,Catherine McAuley Westmead,15190,3,1,2
6244,2013,Catherine McAuley Westmead,15090,1,0,1
6245,2013,Catherine McAuley Westmead,15280,5,0,5
6246,2013,Catherine McAuley Westmead,15350,7,0,7
6247,2013,Catherine McAuley Westmead,15380,6,0,6
6248,2013,Catherine McAuley Westmead,15160,5,0,5
6249,2013,Catherine McAuley Westmead,15680,1,0,1
6250,2013,Catherine McAuley Westmead,15030,3,0,3
6251,2013,Catherine McAuley Westmead,15370,23,2,21
6252,2013,Catherine McAuley Westmead,15620,1,0,1
6253,2013,Catherine McAuley Westmead,26599,3,0,3
6254,2013,Catherine McAuley Westmead,15330,1,0,1
6255,2013,Catherine McAuley Westmead,15400,1,0,1
6256,2013,Catherine McAuley Westmead,15040,4,0,4
6257,2013,Catherine McAuley Westmead,15180,2,1,1
6258,2013,Catherine McAuley Westmead,15140,7,0,7
6259,2013,Catherine McAuley Westmead,15130,1,0,1
6260,2013,Catherine McAuley Westmead,15050,1,0,1
6261,2013,Catherine McAuley Westmead,15290,1,0,1
6262,2013,Catherine McAuley Westmead,15250,4,1,3
6263,2013,Catherine McAuley Westmead,15220,3,1,2
6264,2013,Catherine McAuley Westmead,15020,4,0,4
6265,2013,Clancy Catholic College,15230,3,0,3
6266,2013,Clancy Catholic College,15320,1,0,1
6267,2013,Clancy Catholic College,15370,7,1,6
6268,2013,Clancy Catholic College,15400,1,0,1
6269,2013,Clancy Catholic College,15140,1,0,1
6270,2013,Clancy Catholic College,15290,1,0,1
6271,2013,Clancy Catholic College,15250,1,0,1
6272,2013,Clancy Catholic College,15220,3,0,3
6273,2013,Clancy Catholic College,15020,2,0,2
6274,2013,Swansea High School,26999,1,0,1
6275,2013,Swansea High School,15170,1,0,1
6276,2013,Moriah College,15240,18,10,8
6277,2013,Moriah College,15270,1,0,1
6278,2013,Moriah College,15170,5,1,4
6279,2013,Moriah College,15230,8,5,3
6280,2013,Moriah College,15190,1,1,0
6281,2013,Moriah College,16000,12,8,4
6282,2013,Moriah College,15070,2,0,2
6283,2013,Moriah College,15360,4,4,0
6284,2013,Moriah College,15090,5,0,5
6285,2013,Moriah College,15320,4,2,2
6286,2013,Moriah College,15280,3,2,1
6287,2013,Moriah College,15380,11,3,8
6288,2013,Moriah College,15160,8,3,5
6289,2013,Moriah College,15300,8,7,1
6290,2013,Moriah College,15110,10,7,3
6291,2013,Moriah College,15260,2,1,1
6292,2013,Moriah College,15790,1,0,1
6293,2013,Moriah College,15310,1,1,0
6294,2013,Moriah College,15610,5,3,2
6295,2013,Moriah College,15330,5,5,0
6296,2013,Moriah College,15400,11,1,10
6297,2013,Moriah College,15040,18,12,6
6298,2013,Moriah College,15180,1,0,1
6299,2013,Moriah College,15600,6,4,2
6300,2013,Moriah College,15140,32,16,16
6301,2013,Moriah College,15130,8,2,6
6302,2013,Moriah College,15050,3,3,0
6303,2013,Moriah College,15210,5,5,0
6304,2013,Moriah College,15290,3,0,3
6305,2013,Moriah College,15250,17,11,6
6306,2013,Moriah College,15220,7,2,5
6307,2013,Moriah College,15020,6,6,0
6308,2013,Bishop Druitt College,15240,5,3,2
6309,2013,Bishop Druitt College,15170,3,2,1
6310,2013,Bishop Druitt College,15230,5,2,3
6311,2013,Bishop Druitt College,15320,2,0,2
6312,2013,Bishop Druitt College,15350,1,0,1
6313,2013,Bishop Druitt College,15200,3,2,1
6314,2013,Bishop Druitt College,15160,1,1,0
6315,2013,Bishop Druitt College,15300,1,1,0
6316,2013,Bishop Druitt College,15110,2,2,0
6317,2013,Bishop Druitt College,15680,2,0,2
6318,2013,Bishop Druitt College,15260,1,1,0
6319,2013,Bishop Druitt College,15030,3,1,2
6320,2013,Bishop Druitt College,15370,2,0,2
6321,2013,Bishop Druitt College,26599,1,0,1
6322,2013,Bishop Druitt College,15330,3,2,1
6323,2013,Bishop Druitt College,15400,2,1,1
6324,2013,Bishop Druitt College,15100,2,0,2
6325,2013,Bishop Druitt College,15040,4,1,3
6326,2013,Bishop Druitt College,15180,1,0,1
6327,2013,Bishop Druitt College,15140,8,3,5
6328,2013,Bishop Druitt College,15050,2,1,1
6329,2013,Bishop Druitt College,15250,3,2,1
6330,2013,Bishop Druitt College,15690,1,0,1
6331,2013,Bishop Druitt College,15220,1,0,1
6332,2013,Bishop Druitt College,15020,2,2,0
6333,2013,Bishop Druitt College,15390,3,0,3
6334,2013,Mount Carmel Catholic High School,15240,4,2,2
6335,2013,Mount Carmel Catholic High School,15340,1,0,1
6336,2013,Mount Carmel Catholic High School,15170,2,1,1
6337,2013,Mount Carmel Catholic High School,15230,2,1,1
6338,2013,Mount Carmel Catholic High School,15360,1,1,0
6339,2013,Mount Carmel Catholic High School,15320,1,0,1
6340,2013,Mount Carmel Catholic High School,15350,4,1,3
6341,2013,Mount Carmel Catholic High School,15380,2,2,0
6342,2013,Mount Carmel Catholic High School,15160,2,1,1
6343,2013,Mount Carmel Catholic High School,15680,1,0,1
6344,2013,Mount Carmel Catholic High School,26699,1,1,0
6345,2013,Mount Carmel Catholic High School,15030,2,0,2
6346,2013,Mount Carmel Catholic High School,15370,14,6,8
6347,2013,Mount Carmel Catholic High School,26599,1,0,1
6348,2013,Mount Carmel Catholic High School,15400,5,2,3
6349,2013,Mount Carmel Catholic High School,15060,5,0,5
6350,2013,Mount Carmel Catholic High School,15140,6,1,5
6351,2013,Mount Carmel Catholic High School,15130,1,0,1
6352,2013,Mount Carmel Catholic High School,15050,1,0,1
6353,2013,Mount Carmel Catholic High School,15210,2,2,0
6354,2013,Mount Carmel Catholic High School,15250,1,0,1
6355,2013,Mount Carmel Catholic High School,15220,1,1,0
6356,2013,Smiths Hill High School,15240,20,6,14
6357,2013,Smiths Hill High School,15270,12,6,6
6358,2013,Smiths Hill High School,15170,5,0,5
6359,2013,Smiths Hill High School,15230,10,8,2
6360,2013,Smiths Hill High School,15190,6,5,1
6361,2013,Smiths Hill High School,15070,1,0,1
6362,2013,Smiths Hill High School,15360,1,1,0
6363,2013,Smiths Hill High School,15090,9,3,6
6364,2013,Smiths Hill High School,15320,7,2,5
6365,2013,Smiths Hill High School,15280,1,0,1
6366,2013,Smiths Hill High School,15350,6,0,6
6367,2013,Smiths Hill High School,15160,14,3,11
6368,2013,Smiths Hill High School,15300,3,0,3
6369,2013,Smiths Hill High School,15110,3,1,2
6370,2013,Smiths Hill High School,16050,1,0,1
6371,2013,Smiths Hill High School,15710,1,0,1
6372,2013,Smiths Hill High School,15680,3,0,3
6373,2013,Smiths Hill High School,15260,5,2,3
6374,2013,Smiths Hill High School,16040,1,0,1
6375,2013,Smiths Hill High School,15030,6,1,5
6376,2013,Smiths Hill High School,15370,4,1,3
6377,2013,Smiths Hill High School,15310,2,0,2
6378,2013,Smiths Hill High School,15330,6,3,3
6379,2013,Smiths Hill High School,15040,3,2,1
6380,2013,Smiths Hill High School,15140,10,0,10
6381,2013,Smiths Hill High School,15050,7,2,5
6382,2013,Smiths Hill High School,15210,2,2,0
6383,2013,Smiths Hill High School,15250,14,5,9
6384,2013,Smiths Hill High School,15690,2,0,2
6385,2013,Smiths Hill High School,15220,8,2,6
6386,2013,Smiths Hill High School,15020,5,0,5
6387,2013,Smiths Hill High School,15390,2,0,2
6388,2013,Hornsby Girls High School,15240,27,1,26
6389,2013,Hornsby Girls High School,15270,9,0,9
6390,2013,Hornsby Girls High School,15170,4,0,4
6391,2013,Hornsby Girls High School,15230,11,0,11
6392,2013,Hornsby Girls High School,15830,4,0,4
6393,2013,Hornsby Girls High School,15850,1,0,1
6394,2013,Hornsby Girls High School,15320,4,0,4
6395,2013,Hornsby Girls High School,15280,8,1,7
6396,2013,Hornsby Girls High School,15350,8,0,8
6397,2013,Hornsby Girls High School,15160,37,1,36
6398,2013,Hornsby Girls High School,15300,8,0,8
6399,2013,Hornsby Girls High School,15110,9,0,9
6400,2013,Hornsby Girls High School,15710,1,0,1
6401,2013,Hornsby Girls High School,15680,5,0,5
6402,2013,Hornsby Girls High School,15260,19,0,19
6403,2013,Hornsby Girls High School,15030,11,0,11
6404,2013,Hornsby Girls High School,15310,9,0,9
6405,2013,Hornsby Girls High School,15330,11,0,11
6406,2013,Hornsby Girls High School,15400,11,0,11
6407,2013,Hornsby Girls High School,15040,8,0,8
6408,2013,Hornsby Girls High School,15885,1,1,0
6409,2013,Hornsby Girls High School,15180,3,0,3
6410,2013,Hornsby Girls High School,15140,53,1,52
6411,2013,Hornsby Girls High School,15050,15,0,15
6412,2013,Hornsby Girls High School,15210,3,1,2
6413,2013,Hornsby Girls High School,15290,2,0,2
6414,2013,Hornsby Girls High School,15250,39,1,38
6415,2013,Hornsby Girls High School,15690,2,0,2
6416,2013,Hornsby Girls High School,15220,12,0,12
6417,2013,Hornsby Girls High School,15020,13,0,13
6418,2013,Hornsby Girls High School,15390,4,0,4
6419,2013,Wenona School,15240,3,0,3
6420,2013,Wenona School,15270,14,0,14
6421,2013,Wenona School,15170,6,0,6
6422,2013,Wenona School,15230,18,1,17
6423,2013,Wenona School,15190,16,1,15
6424,2013,Wenona School,15080,5,0,5
6425,2013,Wenona School,15090,2,0,2
6426,2013,Wenona School,15320,4,0,4
6427,2013,Wenona School,15280,7,0,7
6428,2013,Wenona School,15160,17,0,17
6429,2013,Wenona School,15300,2,0,2
6430,2013,Wenona School,15110,6,0,6
6431,2013,Wenona School,15680,1,0,1
6432,2013,Wenona School,15840,1,0,1
6433,2013,Wenona School,15030,3,0,3
6434,2013,Wenona School,15310,1,0,1
6435,2013,Wenona School,15400,11,0,11
6436,2013,Wenona School,15040,5,0,5
6437,2013,Wenona School,15140,40,1,39
6438,2013,Wenona School,15050,3,0,3
6439,2013,Wenona School,15290,3,0,3
6440,2013,Wenona School,15250,3,0,3
6441,2013,Wenona School,15690,1,0,1
6442,2013,Wenona School,15220,9,0,9
6443,2013,Wenona School,15020,6,1,5
6444,2013,Wenona School,15390,10,0,10
6445,2013,Wycliffe Christian School,15240,2,1,1
6446,2013,Wycliffe Christian School,15090,2,0,2
6447,2013,Wycliffe Christian School,15670,1,0,1
6448,2013,Wycliffe Christian School,15350,4,1,3
6449,2013,Wycliffe Christian School,16070,4,1,3
6450,2013,Wycliffe Christian School,15380,1,0,1
6451,2013,Wycliffe Christian School,15330,1,0,1
6452,2013,Wycliffe Christian School,15020,1,1,0
6453,2013,Wycliffe Christian School,15390,1,0,1
6454,2013,Mount Annan High School,15240,2,1,1
6455,2013,Mount Annan High School,15230,1,1,0
6456,2013,Mount Annan High School,15200,1,1,0
6457,2013,Mount Annan High School,15060,2,0,2
6458,2013,Colo High School,15270,2,0,2
6459,2013,Colo High School,15170,1,0,1
6460,2013,Colo High School,15190,1,1,0
6461,2013,Colo High School,15360,1,1,0
6462,2013,Colo High School,15320,3,1,2
6463,2013,Colo High School,15350,3,0,3
6464,2013,Colo High School,15030,1,1,0
6465,2013,Colo High School,15400,4,1,3
6466,2013,Colo High School,15040,1,0,1
6467,2013,Colo High School,15180,2,1,1
6468,2013,Colo High School,15140,2,1,1
6469,2013,Colo High School,15210,2,2,0
6470,2013,Colo High School,15290,3,0,3
6471,2013,All Saints Grammar,15240,1,1,0
6472,2013,All Saints Grammar,15230,1,1,0
6473,2013,All Saints Grammar,15980,2,1,1
6474,2013,All Saints Grammar,15990,3,2,1
6475,2013,All Saints Grammar,15330,1,1,0
6476,2013,All Saints Grammar,15040,2,2,0
6477,2013,All Saints Grammar,15140,3,3,0
6478,2013,All Saints Grammar,15210,3,3,0
6479,2013,All Saints Grammar,15250,2,2,0
6480,2013,All Saints Grammar,15020,1,1,0
6481,2013,Wollondilly Anglican College,15270,1,0,1
6482,2013,Wollondilly Anglican College,15080,2,2,0
6483,2013,Wollondilly Anglican College,15320,1,0,1
6484,2013,Wollondilly Anglican College,15280,1,0,1
6485,2013,Wollondilly Anglican College,15030,1,0,1
6486,2013,Wollondilly Anglican College,15040,1,0,1
6487,2013,Wollondilly Anglican College,15140,1,0,1
6488,2013,Wollondilly Anglican College,15210,1,1,0
6489,2013,Wollondilly Anglican College,15020,1,0,1
6490,2013,Temora High School,15170,1,1,0
6491,2013,Temora High School,15230,3,3,0
6492,2013,Temora High School,15070,1,1,0
6493,2013,Temora High School,15030,2,1,1
6494,2013,Temora High School,15140,2,1,1
6495,2013,Moree Secondary College Albert St Campus,15230,1,1,0
6496,2013,William Carey Christian School,15230,1,1,0
6497,2013,William Carey Christian School,15320,2,1,1
6498,2013,William Carey Christian School,15280,1,1,0
6499,2013,William Carey Christian School,15030,2,1,1
6500,2013,William Carey Christian School,15330,2,2,0
6501,2013,William Carey Christian School,15040,3,1,2
6502,2013,William Carey Christian School,15050,1,1,0
6503,2013,William Carey Christian School,15290,2,1,1
6504,2013,William Carey Christian School,15250,1,1,0
6505,2013,Mount St Patrick College,15240,2,1,1
6506,2013,Mount St Patrick College,15340,10,4,6
6507,2013,Mount St Patrick College,15230,6,3,3
6508,2013,Mount St Patrick College,15320,4,2,2
6509,2013,Mount St Patrick College,15200,1,1,0
6510,2013,Mount St Patrick College,15030,3,1,2
6511,2013,Mount St Patrick College,15400,2,0,2
6512,2013,Mount St Patrick College,15060,4,0,4
6513,2013,Manilla Central School,26999,1,1,0
6514,2013,Manilla Central School,15400,1,1,0
6515,2013,Manilla Central School,26199,1,0,1
6516,2013,International Grammar School,15240,10,5,5
6517,2013,International Grammar School,15270,6,4,2
6518,2013,International Grammar School,15170,3,1,2
6519,2013,International Grammar School,15230,3,2,1
6520,2013,International Grammar School,15080,4,1,3
6521,2013,International Grammar School,16080,2,2,0
6522,2013,International Grammar School,15090,6,4,2
6523,2013,International Grammar School,15320,3,1,2
6524,2013,International Grammar School,15280,2,2,0
6525,2013,International Grammar School,15300,2,0,2
6526,2013,International Grammar School,16090,2,2,0
6527,2013,International Grammar School,15110,6,3,3
6528,2013,International Grammar School,15710,1,0,1
6529,2013,International Grammar School,15680,4,1,3
6530,2013,International Grammar School,15260,3,3,0
6531,2013,International Grammar School,15030,10,4,6
6532,2013,International Grammar School,15310,1,0,1
6533,2013,International Grammar School,15330,2,2,0
6534,2013,International Grammar School,15400,9,4,5
6535,2013,International Grammar School,15800,5,2,3
6536,2013,International Grammar School,15140,13,5,8
6537,2013,International Grammar School,15050,5,4,1
6538,2013,International Grammar School,15290,6,4,2
6539,2013,International Grammar School,15250,10,6,4
6540,2013,International Grammar School,15690,1,0,1
6541,2013,International Grammar School,15020,5,2,3
6542,2013,Kincumber High School,15320,2,0,2
6543,2013,Kincumber High School,15160,1,0,1
6544,2013,Kincumber High School,15260,1,1,0
6545,2013,Kincumber High School,26599,1,0,1
6546,2013,Kincumber High School,15400,2,0,2
6547,2013,Kincumber High School,15140,3,1,2
6548,2013,Kincumber High School,15050,2,1,1
6549,2013,Kincumber High School,15290,2,0,2
6550,2013,Kincumber High School,15250,1,1,0
6551,2013,Kincumber High School,15220,2,0,2
6552,2013,"St Patrick's College, Strathfield",15240,11,11,0
6553,2013,"St Patrick's College, Strathfield",15270,11,11,0
6554,2013,"St Patrick's College, Strathfield",15340,3,3,0
6555,2013,"St Patrick's College, Strathfield",26999,1,1,0
6556,2013,"St Patrick's College, Strathfield",15170,2,2,0
6557,2013,"St Patrick's College, Strathfield",15230,10,10,0
6558,2013,"St Patrick's College, Strathfield",15190,2,2,0
6559,2013,"St Patrick's College, Strathfield",15320,7,7,0
6560,2013,"St Patrick's College, Strathfield",15280,1,1,0
6561,2013,"St Patrick's College, Strathfield",15200,8,8,0
6562,2013,"St Patrick's College, Strathfield",15160,5,5,0
6563,2013,"St Patrick's College, Strathfield",15300,2,2,0
6564,2013,"St Patrick's College, Strathfield",15110,7,7,0
6565,2013,"St Patrick's College, Strathfield",15030,7,7,0
6566,2013,"St Patrick's College, Strathfield",15370,26,26,0
6567,2013,"St Patrick's College, Strathfield",15310,3,3,0
6568,2013,"St Patrick's College, Strathfield",15810,1,1,0
6569,2013,"St Patrick's College, Strathfield",15330,3,3,0
6570,2013,"St Patrick's College, Strathfield",15400,8,8,0
6571,2013,"St Patrick's College, Strathfield",15040,12,12,0
6572,2013,"St Patrick's College, Strathfield",15800,3,3,0
6573,2013,"St Patrick's College, Strathfield",15140,7,7,0
6574,2013,"St Patrick's College, Strathfield",15130,2,2,0
6575,2013,"St Patrick's College, Strathfield",15050,3,3,0
6576,2013,"St Patrick's College, Strathfield",15250,5,5,0
6577,2013,"St Patrick's College, Strathfield",15220,7,7,0
6578,2013,"St Patrick's College, Strathfield",15020,2,2,0
6579,2013,Erina High School,15350,1,0,1
6580,2013,Erina High School,15200,1,1,0
6581,2013,Erina High School,15160,1,0,1
6582,2013,Erina High School,15400,1,0,1
6583,2013,Erina High School,15060,1,0,1
6584,2013,Erina High School,15020,2,0,2
6585,2013,Erina High School,15390,1,0,1
6586,2013,Warrawong High School,15210,2,1,1
6587,2013,Warrawong High School,16120,1,0,1
6588,2013,The King's School,15240,23,19,4
6589,2013,The King's School,15270,8,8,0
6590,2013,The King's School,15340,3,3,0
6591,2013,The King's School,15170,2,1,1
6592,2013,The King's School,15230,32,32,0
6593,2013,The King's School,15190,12,11,1
6594,2013,The King's School,15120,1,1,0
6595,2013,The King's School,15360,3,3,0
6596,2013,The King's School,15090,14,13,1
6597,2013,The King's School,15320,6,6,0
6598,2013,The King's School,15280,3,3,0
6599,2013,The King's School,15200,4,4,0
6600,2013,The King's School,15380,2,2,0
6601,2013,The King's School,15160,9,8,1
6602,2013,The King's School,15300,3,3,0
6603,2013,The King's School,15110,9,7,2
6604,2013,The King's School,15910,2,2,0
6605,2013,The King's School,15710,3,3,0
6606,2013,The King's School,15680,2,2,0
6607,2013,The King's School,15260,13,12,1
6608,2013,The King's School,15900,2,2,0
6609,2013,The King's School,15030,7,7,0
6610,2013,The King's School,15310,4,4,0
6611,2013,The King's School,15330,11,10,1
6612,2013,The King's School,15400,3,3,0
6613,2013,The King's School,15100,3,3,0
6614,2013,The King's School,15040,15,15,0
6615,2013,The King's School,15800,1,1,0
6616,2013,The King's School,15140,24,21,3
6617,2013,The King's School,15050,11,10,1
6618,2013,The King's School,15210,2,2,0
6619,2013,The King's School,15250,28,24,4
6620,2013,The King's School,15220,7,7,0
6621,2013,The King's School,15020,4,4,0
6622,2013,The King's School,15010,1,1,0
6623,2013,South Western Sydney Institute - Granville Campus,15030,1,1,0
6624,2013,South Western Sydney Institute - Granville Campus,15050,1,1,0
6625,2013,South Western Sydney Institute - Granville Campus,15220,1,1,0
6626,2013,Illawarra Senior College,15020,1,0,1
6627,2013,Yanco Agricultural High School,15340,5,1,4
6628,2013,Yanco Agricultural High School,15230,1,0,1
6629,2013,Yanco Agricultural High School,15290,2,0,2
6630,2013,Yanco Agricultural High School,15010,1,0,1
6631,2013,Georges River College Oatley Senior Campus,15240,12,6,6
6632,2013,Georges River College Oatley Senior Campus,15270,2,1,1
6633,2013,Georges River College Oatley Senior Campus,15340,4,4,0
6634,2013,Georges River College Oatley Senior Campus,15230,14,5,9
6635,2013,Georges River College Oatley Senior Campus,27199,1,0,1
6636,2013,Georges River College Oatley Senior Campus,15350,1,0,1
6637,2013,Georges River College Oatley Senior Campus,15820,1,0,1
6638,2013,Georges River College Oatley Senior Campus,15030,3,2,1
6639,2013,Georges River College Oatley Senior Campus,15310,1,0,1
6640,2013,Georges River College Oatley Senior Campus,26599,1,0,1
6641,2013,Georges River College Oatley Senior Campus,15970,2,0,2
6642,2013,Georges River College Oatley Senior Campus,15040,7,3,4
6643,2013,Georges River College Oatley Senior Campus,15180,1,0,1
6644,2013,Georges River College Oatley Senior Campus,15060,4,1,3
6645,2013,Georges River College Oatley Senior Campus,15140,5,0,5
6646,2013,Georges River College Oatley Senior Campus,15050,4,2,2
6647,2013,Georges River College Oatley Senior Campus,15210,2,1,1
6648,2013,Georges River College Oatley Senior Campus,15250,14,6,8
6649,2013,Georges River College Oatley Senior Campus,15220,3,0,3
6650,2013,Georges River College Oatley Senior Campus,15020,4,0,4
6651,2013,Georges River College Oatley Senior Campus,15390,2,0,2
6652,2013,Ashford Central School,15340,1,0,1
6653,2013,Ashford Central School,26199,1,0,1
6654,2013,Ashford Central School,15220,1,0,1
6655,2013,Riverside Girls High School,15270,4,0,4
6656,2013,Riverside Girls High School,15170,4,0,4
6657,2013,Riverside Girls High School,15230,5,1,4
6658,2013,Riverside Girls High School,15830,1,1,0
6659,2013,Riverside Girls High School,15890,1,0,1
6660,2013,Riverside Girls High School,15090,5,0,5
6661,2013,Riverside Girls High School,15670,2,0,2
6662,2013,Riverside Girls High School,15350,1,0,1
6663,2013,Riverside Girls High School,15820,1,0,1
6664,2013,Riverside Girls High School,15300,2,0,2
6665,2013,Riverside Girls High School,15560,1,0,1
6666,2013,Riverside Girls High School,26699,2,0,2
6667,2013,Riverside Girls High School,15030,3,0,3
6668,2013,Riverside Girls High School,15310,1,0,1
6669,2013,Riverside Girls High School,26599,1,1,0
6670,2013,Riverside Girls High School,15330,3,0,3
6671,2013,Riverside Girls High School,15510,1,0,1
6672,2013,Riverside Girls High School,15150,1,0,1
6673,2013,Riverside Girls High School,15400,1,0,1
6674,2013,Riverside Girls High School,15100,2,0,2
6675,2013,Riverside Girls High School,15040,4,1,3
6676,2013,Riverside Girls High School,15885,2,1,1
6677,2013,Riverside Girls High School,15060,2,0,2
6678,2013,Riverside Girls High School,15140,2,0,2
6679,2013,Riverside Girls High School,15050,1,0,1
6680,2013,Riverside Girls High School,15290,1,1,0
6681,2013,Riverside Girls High School,15250,1,0,1
6682,2013,Riverside Girls High School,15220,9,0,9
6683,2013,Riverside Girls High School,15020,2,0,2
6684,2013,Riverside Girls High School,15390,1,0,1
6685,2013,St Aloysius' College,15240,45,44,1
6686,2013,St Aloysius' College,15270,29,29,0
6687,2013,St Aloysius' College,15340,3,3,0
6688,2013,St Aloysius' College,15230,21,21,0
6689,2013,St Aloysius' College,15190,4,4,0
6690,2013,St Aloysius' College,15090,4,4,0
6691,2013,St Aloysius' College,15320,6,6,0
6692,2013,St Aloysius' College,15280,8,8,0
6693,2013,St Aloysius' College,15380,13,13,0
6694,2013,St Aloysius' College,15160,8,8,0
6695,2013,St Aloysius' College,15300,2,2,0
6696,2013,St Aloysius' College,15110,10,10,0
6697,2013,St Aloysius' College,15680,2,2,0
6698,2013,St Aloysius' College,15540,1,1,0
6699,2013,St Aloysius' College,16020,1,1,0
6700,2013,St Aloysius' College,15260,5,4,1
6701,2013,St Aloysius' College,15030,7,7,0
6702,2013,St Aloysius' College,15370,4,4,0
6703,2013,St Aloysius' College,15310,2,2,0
6704,2013,St Aloysius' College,15330,9,8,1
6705,2013,St Aloysius' College,15400,18,18,0
6706,2013,St Aloysius' College,15040,6,6,0
6707,2013,St Aloysius' College,15140,52,51,1
6708,2013,St Aloysius' College,15130,1,1,0
6709,2013,St Aloysius' College,15050,9,8,1
6710,2013,St Aloysius' College,15290,5,5,0
6711,2013,St Aloysius' College,15250,19,18,1
6712,2013,St Aloysius' College,15690,1,1,0
6713,2013,St Aloysius' College,15220,4,4,0
6714,2013,St Aloysius' College,15020,14,14,0
6715,2013,Alstonville High School,15240,2,0,2
6716,2013,Alstonville High School,15270,1,0,1
6717,2013,Alstonville High School,15170,1,0,1
6718,2013,Alstonville High School,15080,1,1,0
6719,2013,Alstonville High School,15120,1,1,0
6720,2013,Alstonville High School,15320,1,0,1
6721,2013,Alstonville High School,15350,1,0,1
6722,2013,Alstonville High School,15110,2,2,0
6723,2013,Alstonville High School,15330,2,2,0
6724,2013,Alstonville High School,15400,1,0,1
6725,2013,Alstonville High School,15040,1,0,1
6726,2013,Alstonville High School,15140,7,2,5
6727,2013,Alstonville High School,15050,4,2,2
6728,2013,Alstonville High School,15210,1,1,0
6729,2013,Alstonville High School,15290,1,0,1
6730,2013,Alstonville High School,15250,3,3,0
6731,2013,Alstonville High School,15220,3,2,1
6732,2013,Alstonville High School,15020,1,0,1
6733,2013,Alstonville High School,15390,1,0,1
6734,2013,IPEKA INTERNATIONAL Christian School,15240,13,7,6
6735,2013,IPEKA INTERNATIONAL Christian School,15360,1,1,0
6736,2013,IPEKA INTERNATIONAL Christian School,15040,1,0,1
6737,2013,IPEKA INTERNATIONAL Christian School,15250,6,2,4
6738,2013,Baulkham Hills High School,15240,50,30,20
6739,2013,Baulkham Hills High School,15270,9,5,4
6740,2013,Baulkham Hills High School,15170,7,1,6
6741,2013,Baulkham Hills High School,15190,1,0,1
6742,2013,Baulkham Hills High School,15830,1,0,1
6743,2013,Baulkham Hills High School,15120,5,4,1
6744,2013,Baulkham Hills High School,15320,2,2,0
6745,2013,Baulkham Hills High School,15280,2,0,2
6746,2013,Baulkham Hills High School,15160,34,11,23
6747,2013,Baulkham Hills High School,15300,5,3,2
6748,2013,Baulkham Hills High School,15110,26,17,9
6749,2013,Baulkham Hills High School,15910,4,1,3
6750,2013,Baulkham Hills High School,15260,61,39,22
6751,2013,Baulkham Hills High School,15900,3,1,2
6752,2013,Baulkham Hills High School,15030,19,9,10
6753,2013,Baulkham Hills High School,15310,5,4,1
6754,2013,Baulkham Hills High School,15330,50,33,17
6755,2013,Baulkham Hills High School,15400,6,2,4
6756,2013,Baulkham Hills High School,15040,6,3,3
6757,2013,Baulkham Hills High School,15140,99,50,49
6758,2013,Baulkham Hills High School,15050,57,38,19
6759,2013,Baulkham Hills High School,15250,110,67,43
6760,2013,Baulkham Hills High School,15220,7,3,4
6761,2013,Baulkham Hills High School,15020,7,3,4
6762,2013,Oak Flats High School,15340,1,0,1
6763,2013,Oak Flats High School,26999,1,0,1
6764,2013,Oak Flats High School,15200,1,0,1
6765,2013,Oak Flats High School,15060,2,0,2
6766,2013,Lockhart Central School,15320,1,0,1
6767,2013,Greystanes High School,15240,2,2,0
6768,2013,Greystanes High School,15340,4,2,2
6769,2013,Greystanes High School,15120,2,2,0
6770,2013,Greystanes High School,15320,5,1,4
6771,2013,Greystanes High School,15160,2,1,1
6772,2013,Greystanes High School,15030,3,1,2
6773,2013,Greystanes High School,15040,1,0,1
6774,2013,Greystanes High School,15180,1,0,1
6775,2013,Greystanes High School,15060,9,0,9
6776,2013,Greystanes High School,15140,2,1,1
6777,2013,Greystanes High School,15050,1,1,0
6778,2013,Greystanes High School,15210,3,3,0
6779,2013,Greystanes High School,15250,1,1,0
6780,2013,Greystanes High School,15020,1,0,1
6781,2013,Bankstown Girls High School,15230,1,1,0
6782,2013,Bankstown Girls High School,15940,1,0,1
6783,2013,Bankstown Girls High School,15210,1,0,1
6784,2013,Bankstown Girls High School,15250,1,0,1
6785,2013,La Salle Academy,15170,1,0,1
6786,2013,La Salle Academy,15230,1,0,1
6787,2013,La Salle Academy,15380,1,1,0
6788,2013,La Salle Academy,15290,1,0,1
6789,2013,Rutherford High School,15060,1,0,1
6790,2013,St Charbel's College,15240,2,2,0
6791,2013,St Charbel's College,15270,1,1,0
6792,2013,St Charbel's College,15230,2,1,1
6793,2013,St Charbel's College,15320,2,1,1
6794,2013,St Charbel's College,15160,1,0,1
6795,2013,St Charbel's College,15110,1,1,0
6796,2013,St Charbel's College,15030,2,1,1
6797,2013,St Charbel's College,15370,1,1,0
6798,2013,St Charbel's College,15400,1,1,0
6799,2013,St Charbel's College,15040,1,1,0
6800,2013,St Charbel's College,15060,1,0,1
6801,2013,St Charbel's College,15140,2,1,1
6802,2013,St Charbel's College,15290,1,0,1
6803,2013,St Charbel's College,15250,1,0,1
6804,2013,St Charbel's College,15220,8,5,3
6805,2013,St Charbel's College,15020,3,0,3
6806,2013,St Charbel's College,15390,1,0,1
6807,2013,Narrabri High School,15200,1,0,1
6808,2013,Narrabri High School,15290,2,0,2
6809,2013,Narrabri High School,15390,1,0,1
6810,2013,Nowra High School,26899,1,0,1
6811,2013,Nowra High School,15230,1,1,0
6812,2013,Nowra High School,15070,2,0,2
6813,2013,Nowra High School,15670,1,0,1
6814,2013,Nowra High School,15350,1,0,1
6815,2013,Nowra High School,15200,1,1,0
6816,2013,Nowra High School,15000,2,0,2
6817,2013,Nowra High School,15400,2,1,1
6818,2013,Nowra High School,15040,2,1,1
6819,2013,Nowra High School,15060,1,0,1
6820,2013,Nowra High School,15140,1,0,1
6821,2013,Nowra High School,15290,1,0,1
6822,2013,Nowra High School,15220,1,0,1
6823,2013,Nowra High School,15020,1,0,1
6824,2013,Peel High School,15320,1,1,0
6825,2013,SHORE - Sydney Church of England Grammar School,15240,39,37,2
6826,2013,SHORE - Sydney Church of England Grammar School,15270,27,26,1
6827,2013,SHORE - Sydney Church of England Grammar School,15340,1,1,0
6828,2013,SHORE - Sydney Church of England Grammar School,15170,4,4,0
6829,2013,SHORE - Sydney Church of England Grammar School,15230,40,40,0
6830,2013,SHORE - Sydney Church of England Grammar School,15190,22,22,0
6831,2013,SHORE - Sydney Church of England Grammar School,15080,2,2,0
6832,2013,SHORE - Sydney Church of England Grammar School,15830,1,1,0
6833,2013,SHORE - Sydney Church of England Grammar School,15090,7,7,0
6834,2013,SHORE - Sydney Church of England Grammar School,15320,2,2,0
6835,2013,SHORE - Sydney Church of England Grammar School,15280,6,6,0
6836,2013,SHORE - Sydney Church of England Grammar School,15200,4,4,0
6837,2013,SHORE - Sydney Church of England Grammar School,15160,12,12,0
6838,2013,SHORE - Sydney Church of England Grammar School,15300,2,2,0
6839,2013,SHORE - Sydney Church of England Grammar School,15110,18,18,0
6840,2013,SHORE - Sydney Church of England Grammar School,15910,2,2,0
6841,2013,SHORE - Sydney Church of England Grammar School,15680,3,3,0
6842,2013,SHORE - Sydney Church of England Grammar School,15260,10,10,0
6843,2013,SHORE - Sydney Church of England Grammar School,15900,1,1,0
6844,2013,SHORE - Sydney Church of England Grammar School,15030,6,6,0
6845,2013,SHORE - Sydney Church of England Grammar School,15370,4,4,0
6846,2013,SHORE - Sydney Church of England Grammar School,15310,3,3,0
6847,2013,SHORE - Sydney Church of England Grammar School,15330,11,11,0
6848,2013,SHORE - Sydney Church of England Grammar School,15150,1,1,0
6849,2013,SHORE - Sydney Church of England Grammar School,15400,7,7,0
6850,2013,SHORE - Sydney Church of England Grammar School,15040,36,35,1
6851,2013,SHORE - Sydney Church of England Grammar School,15140,33,33,0
6852,2013,SHORE - Sydney Church of England Grammar School,15130,3,3,0
6853,2013,SHORE - Sydney Church of England Grammar School,15050,15,15,0
6854,2013,SHORE - Sydney Church of England Grammar School,15210,2,1,1
6855,2013,SHORE - Sydney Church of England Grammar School,15290,4,4,0
6856,2013,SHORE - Sydney Church of England Grammar School,15250,21,21,0
6857,2013,SHORE - Sydney Church of England Grammar School,15690,2,2,0
6858,2013,SHORE - Sydney Church of England Grammar School,15020,6,6,0
6859,2013,Macquarie Fields High School,15240,21,9,12
6860,2013,Macquarie Fields High School,15270,2,1,1
6861,2013,Macquarie Fields High School,15340,2,0,2
6862,2013,Macquarie Fields High School,15170,1,0,1
6863,2013,Macquarie Fields High School,15120,3,3,0
6864,2013,Macquarie Fields High School,15360,1,1,0
6865,2013,Macquarie Fields High School,15320,1,0,1
6866,2013,Macquarie Fields High School,15350,7,2,5
6867,2013,Macquarie Fields High School,15200,5,3,2
6868,2013,Macquarie Fields High School,15820,3,1,2
6869,2013,Macquarie Fields High School,15160,1,0,1
6870,2013,Macquarie Fields High School,15110,3,1,2
6871,2013,Macquarie Fields High School,15260,5,4,1
6872,2013,Macquarie Fields High School,15030,3,1,2
6873,2013,Macquarie Fields High School,15370,1,0,1
6874,2013,Macquarie Fields High School,15330,3,1,2
6875,2013,Macquarie Fields High School,15400,1,0,1
6876,2013,Macquarie Fields High School,15100,1,1,0
6877,2013,Macquarie Fields High School,15040,1,0,1
6878,2013,Macquarie Fields High School,15140,9,4,5
6879,2013,Macquarie Fields High School,15050,9,4,5
6880,2013,Macquarie Fields High School,15290,3,1,2
6881,2013,Macquarie Fields High School,15250,21,15,6
6882,2013,Macquarie Fields High School,15220,2,2,0
6883,2013,Macquarie Fields High School,15020,2,0,2
6884,2013,Lambton High School,15240,1,1,0
6885,2013,Lambton High School,15270,3,1,2
6886,2013,Lambton High School,15230,1,0,1
6887,2013,Lambton High School,15120,1,1,0
6888,2013,Lambton High School,15090,3,0,3
6889,2013,Lambton High School,15320,3,0,3
6890,2013,Lambton High School,15280,1,0,1
6891,2013,Lambton High School,15670,1,0,1
6892,2013,Lambton High School,15350,1,0,1
6893,2013,Lambton High School,15380,2,0,2
6894,2013,Lambton High School,15160,4,0,4
6895,2013,Lambton High School,15680,1,0,1
6896,2013,Lambton High School,15400,6,0,6
6897,2013,Lambton High School,15100,3,0,3
6898,2013,Lambton High School,15040,2,0,2
6899,2013,Lambton High School,15060,2,0,2
6900,2013,Lambton High School,15140,1,0,1
6901,2013,Lambton High School,15290,4,3,1
6902,2013,Lambton High School,15220,1,0,1
6903,2013,Lambton High School,15020,1,0,1
6904,2013,Terra Sancta College (Quakers Hill Campus),15240,1,1,0
6905,2013,Terra Sancta College (Quakers Hill Campus),15340,1,1,0
6906,2013,Terra Sancta College (Quakers Hill Campus),15230,1,1,0
6907,2013,Terra Sancta College (Quakers Hill Campus),15320,1,0,1
6908,2013,Terra Sancta College (Quakers Hill Campus),15380,1,0,1
6909,2013,Terra Sancta College (Quakers Hill Campus),15160,2,1,1
6910,2013,Terra Sancta College (Quakers Hill Campus),15370,2,0,2
6911,2013,Terra Sancta College (Quakers Hill Campus),26599,3,1,2
6912,2013,Terra Sancta College (Quakers Hill Campus),15180,3,0,3
6913,2013,Terra Sancta College (Quakers Hill Campus),15060,5,0,5
6914,2013,Terra Sancta College (Quakers Hill Campus),15290,2,1,1
6915,2013,Terra Sancta College (Quakers Hill Campus),15250,1,1,0
6916,2013,Terra Sancta College (Quakers Hill Campus),15020,1,0,1
6917,2013,Keira High School,15270,1,1,0
6918,2013,Keira High School,15230,1,0,1
6919,2013,Keira High School,15320,1,0,1
6920,2013,Keira High School,15280,1,1,0
6921,2013,Keira High School,15350,1,0,1
6922,2013,Keira High School,15160,1,0,1
6923,2013,Keira High School,15330,1,1,0
6924,2013,Keira High School,15400,1,0,1
6925,2013,Keira High School,15180,1,0,1
6926,2013,Keira High School,15060,1,0,1
6927,2013,Keira High School,15140,1,1,0
6928,2013,Keira High School,16120,1,0,1
6929,2013,Keira High School,15020,2,2,0
6930,2013,Warilla High School,15230,2,1,1
6931,2013,Warilla High School,15030,2,0,2
6932,2013,Warilla High School,15290,1,0,1
6933,2013,Eden Marine High School,15240,2,2,0
6934,2013,Eden Marine High School,15230,3,3,0
6935,2013,Eden Marine High School,15120,1,1,0
6936,2013,Eden Marine High School,15320,1,0,1
6937,2013,Eden Marine High School,15280,2,0,2
6938,2013,Eden Marine High School,15350,2,1,1
6939,2013,Eden Marine High School,15160,1,0,1
6940,2013,Eden Marine High School,26599,1,0,1
6941,2013,Eden Marine High School,15330,1,1,0
6942,2013,Eden Marine High School,15140,1,0,1
6943,2013,Eden Marine High School,15290,3,1,2
6944,2013,Eden Marine High School,15020,1,0,1
6945,2013,Lindisfarne Anglican Grammar School,15270,1,0,1
6946,2013,Lindisfarne Anglican Grammar School,15340,2,1,1
6947,2013,Lindisfarne Anglican Grammar School,15170,1,0,1
6948,2013,Lindisfarne Anglican Grammar School,15230,1,0,1
6949,2013,Lindisfarne Anglican Grammar School,15120,1,1,0
6950,2013,Lindisfarne Anglican Grammar School,15670,1,0,1
6951,2013,Lindisfarne Anglican Grammar School,15160,2,0,2
6952,2013,Lindisfarne Anglican Grammar School,15030,2,1,1
6953,2013,Lindisfarne Anglican Grammar School,26599,1,1,0
6954,2013,Lindisfarne Anglican Grammar School,15330,1,1,0
6955,2013,Lindisfarne Anglican Grammar School,15400,4,0,4
6956,2013,Lindisfarne Anglican Grammar School,15140,1,0,1
6957,2013,Lindisfarne Anglican Grammar School,15290,1,1,0
6958,2013,Lindisfarne Anglican Grammar School,15250,1,1,0
6959,2013,Lindisfarne Anglican Grammar School,15220,1,0,1
6960,2013,Lindisfarne Anglican Grammar School,15020,1,0,1
6961,2013,Coolah Central School,15400,1,1,0
6962,2013,St Catherine's Catholic College,15080,2,1,1
6963,2013,St Catherine's Catholic College,15290,1,0,1
6964,2013,Masada College,15240,6,5,1
6965,2013,Masada College,15270,3,1,2
6966,2013,Masada College,15170,1,0,1
6967,2013,Masada College,15230,8,5,3
6968,2013,Masada College,15080,3,0,3
6969,2013,Masada College,16000,5,4,1
6970,2013,Masada College,15850,1,1,0
6971,2013,Masada College,15320,1,0,1
6972,2013,Masada College,15280,1,1,0
6973,2013,Masada College,15350,6,1,5
6974,2013,Masada College,15160,3,0,3
6975,2013,Masada College,15110,11,8,3
6976,2013,Masada College,15560,1,0,1
6977,2013,Masada College,15260,2,2,0
6978,2013,Masada College,15030,3,1,2
6979,2013,Masada College,15310,1,1,0
6980,2013,Masada College,26599,2,1,1
6981,2013,Masada College,27299,1,0,1
6982,2013,Masada College,15330,1,1,0
6983,2013,Masada College,15400,8,2,6
6984,2013,Masada College,15040,12,5,7
6985,2013,Masada College,15180,1,0,1
6986,2013,Masada College,15140,5,3,2
6987,2013,Masada College,15050,3,2,1
6988,2013,Masada College,15290,2,2,0
6989,2013,Masada College,15250,4,4,0
6990,2013,Masada College,15020,3,0,3
6991,2013,Northern Beaches Secondary College Freshwater Senior Campus,15240,6,3,3
6992,2013,Northern Beaches Secondary College Freshwater Senior Campus,15340,9,2,7
6993,2013,Northern Beaches Secondary College Freshwater Senior Campus,15170,4,2,2
6994,2013,Northern Beaches Secondary College Freshwater Senior Campus,15230,7,3,4
6995,2013,Northern Beaches Secondary College Freshwater Senior Campus,15190,1,0,1
6996,2013,Northern Beaches Secondary College Freshwater Senior Campus,15120,2,2,0
6997,2013,Northern Beaches Secondary College Freshwater Senior Campus,15070,3,1,2
6998,2013,Northern Beaches Secondary College Freshwater Senior Campus,15720,1,0,1
6999,2013,Northern Beaches Secondary College Freshwater Senior Campus,15360,3,3,0
7000,2013,Northern Beaches Secondary College Freshwater Senior Campus,15090,3,0,3
7001,2013,Northern Beaches Secondary College Freshwater Senior Campus,15320,1,1,0
7002,2013,Northern Beaches Secondary College Freshwater Senior Campus,15280,2,1,1
7003,2013,Northern Beaches Secondary College Freshwater Senior Campus,15350,14,4,10
7004,2013,Northern Beaches Secondary College Freshwater Senior Campus,16070,1,0,1
7005,2013,Northern Beaches Secondary College Freshwater Senior Campus,15160,1,1,0
7006,2013,Northern Beaches Secondary College Freshwater Senior Campus,15300,1,1,0
7007,2013,Northern Beaches Secondary College Freshwater Senior Campus,15110,2,2,0
7008,2013,Northern Beaches Secondary College Freshwater Senior Campus,15710,2,0,2
7009,2013,Northern Beaches Secondary College Freshwater Senior Campus,15560,2,1,1
7010,2013,Northern Beaches Secondary College Freshwater Senior Campus,15680,1,1,0
7011,2013,Northern Beaches Secondary College Freshwater Senior Campus,26699,1,0,1
7012,2013,Northern Beaches Secondary College Freshwater Senior Campus,15030,4,1,3
7013,2013,Northern Beaches Secondary College Freshwater Senior Campus,15310,1,1,0
7014,2013,Northern Beaches Secondary College Freshwater Senior Campus,26599,4,0,4
7015,2013,Northern Beaches Secondary College Freshwater Senior Campus,15330,3,3,0
7016,2013,Northern Beaches Secondary College Freshwater Senior Campus,15400,10,3,7
7017,2013,Northern Beaches Secondary College Freshwater Senior Campus,15100,1,1,0
7018,2013,Northern Beaches Secondary College Freshwater Senior Campus,15040,9,5,4
7019,2013,Northern Beaches Secondary College Freshwater Senior Campus,15180,4,1,3
7020,2013,Northern Beaches Secondary College Freshwater Senior Campus,15060,10,0,10
7021,2013,Northern Beaches Secondary College Freshwater Senior Campus,15140,23,11,12
7022,2013,Northern Beaches Secondary College Freshwater Senior Campus,15210,6,3,3
7023,2013,Northern Beaches Secondary College Freshwater Senior Campus,15290,5,4,1
7024,2013,Northern Beaches Secondary College Freshwater Senior Campus,15250,3,2,1
7025,2013,Northern Beaches Secondary College Freshwater Senior Campus,15220,5,3,2
7026,2013,Northern Beaches Secondary College Freshwater Senior Campus,15020,5,1,4
7027,2013,Northern Beaches Secondary College Freshwater Senior Campus,15390,3,1,2
7028,2013,Northern Beaches Secondary College Freshwater Senior Campus,15700,1,1,0
7029,2013,Richard Johnson Anglican School,15270,1,0,1
7030,2013,Richard Johnson Anglican School,15360,1,1,0
7031,2013,Richard Johnson Anglican School,15090,1,0,1
7032,2013,Richard Johnson Anglican School,15820,1,0,1
7033,2013,Richard Johnson Anglican School,15160,1,0,1
7034,2013,Richard Johnson Anglican School,15330,1,1,0
7035,2013,Richard Johnson Anglican School,15400,1,0,1
7036,2013,Richard Johnson Anglican School,15140,1,0,1
7037,2013,Richard Johnson Anglican School,15290,1,0,1
7038,2013,Richard Johnson Anglican School,15250,1,1,0
7039,2013,Southern Cross School,15240,1,1,0
7040,2013,Southern Cross School,15230,1,0,1
7041,2013,Southern Cross School,15120,1,1,0
7042,2013,Southern Cross School,15350,1,0,1
7043,2013,Southern Cross School,15820,1,0,1
7044,2013,Southern Cross School,15330,1,1,0
7045,2013,Southern Cross School,15290,2,2,0
7046,2013,McAuley Catholic College,15240,3,2,1
7047,2013,McAuley Catholic College,15270,3,2,1
7048,2013,McAuley Catholic College,15340,3,2,1
7049,2013,McAuley Catholic College,15230,2,1,1
7050,2013,McAuley Catholic College,15190,1,1,0
7051,2013,McAuley Catholic College,15200,1,1,0
7052,2013,McAuley Catholic College,15380,6,3,3
7053,2013,McAuley Catholic College,15030,1,0,1
7054,2013,McAuley Catholic College,26599,1,0,1
7055,2013,McAuley Catholic College,15400,4,0,4
7056,2013,McAuley Catholic College,15040,2,0,2
7057,2013,McAuley Catholic College,15140,1,1,0
7058,2013,McAuley Catholic College,15130,3,1,2
7059,2013,McAuley Catholic College,15220,2,2,0
7060,2013,Regents Park Christian School,15240,1,1,0
7061,2013,Regents Park Christian School,15230,2,0,2
7062,2013,Regents Park Christian School,15360,1,1,0
7063,2013,Regents Park Christian School,15670,4,1,3
7064,2013,Regents Park Christian School,15030,2,1,1
7065,2013,Regents Park Christian School,15050,1,1,0
7066,2013,Regents Park Christian School,15290,1,0,1
7067,2013,Regents Park Christian School,15250,5,4,1
7068,2013,Regents Park Christian School,15220,1,0,1
7069,2013,Regents Park Christian School,15020,1,0,1
7070,2013,Blaxland High School,15230,6,1,5
7071,2013,Blaxland High School,15200,2,2,0
7072,2013,Blaxland High School,15160,1,0,1
7073,2013,Blaxland High School,15680,1,0,1
7074,2013,Blaxland High School,15260,1,1,0
7075,2013,Blaxland High School,15030,1,0,1
7076,2013,Blaxland High School,26399,1,1,0
7077,2013,Blaxland High School,15400,4,2,2
7078,2013,Blaxland High School,15180,1,1,0
7079,2013,Blaxland High School,15140,1,0,1
7080,2013,Blaxland High School,15290,8,3,5
7081,2013,Blaxland High School,15250,1,1,0
7082,2013,Trinity Grammar School,15240,19,19,0
7083,2013,Trinity Grammar School,15270,5,5,0
7084,2013,Trinity Grammar School,15170,1,1,0
7085,2013,Trinity Grammar School,15230,4,4,0
7086,2013,Trinity Grammar School,15080,2,2,0
7087,2013,Trinity Grammar School,15360,1,1,0
7088,2013,Trinity Grammar School,15280,2,2,0
7089,2013,Trinity Grammar School,15200,3,3,0
7090,2013,Trinity Grammar School,15160,5,5,0
7091,2013,Trinity Grammar School,15300,3,3,0
7092,2013,Trinity Grammar School,15110,5,5,0
7093,2013,Trinity Grammar School,15910,1,0,1
7094,2013,Trinity Grammar School,15260,3,3,0
7095,2013,Trinity Grammar School,15030,4,4,0
7096,2013,Trinity Grammar School,15310,5,5,0
7097,2013,Trinity Grammar School,15330,6,6,0
7098,2013,Trinity Grammar School,15400,3,3,0
7099,2013,Trinity Grammar School,15040,10,10,0
7100,2013,Trinity Grammar School,15140,9,8,1
7101,2013,Trinity Grammar School,15050,5,4,1
7102,2013,Trinity Grammar School,15210,2,2,0
7103,2013,Trinity Grammar School,15290,2,2,0
7104,2013,Trinity Grammar School,15250,10,9,1
7105,2013,Trinity Grammar School,15220,3,3,0
7106,2013,Trinity Grammar School,15020,1,1,0
7107,2013,Wagga Wagga High School,15230,3,1,2
7108,2013,Wagga Wagga High School,15830,1,0,1
7109,2013,Wagga Wagga High School,27199,1,0,1
7110,2013,Wagga Wagga High School,15070,1,0,1
7111,2013,Wagga Wagga High School,15090,2,1,1
7112,2013,Wagga Wagga High School,26399,1,1,0
7113,2013,Wagga Wagga High School,15140,1,0,1
7114,2013,Wagga Wagga High School,15290,2,0,2
7115,2013,Wagga Wagga High School,15220,2,1,1
7116,2013,Wagga Wagga High School,15020,2,0,2
7117,2013,Concord High School,15240,4,2,2
7118,2013,Concord High School,15270,1,0,1
7119,2013,Concord High School,15230,9,5,4
7120,2013,Concord High School,15120,3,3,0
7121,2013,Concord High School,15320,1,1,0
7122,2013,Concord High School,16070,1,0,1
7123,2013,Concord High School,15160,4,1,3
7124,2013,Concord High School,15560,2,1,1
7125,2013,Concord High School,15260,5,3,2
7126,2013,Concord High School,15400,2,1,1
7127,2013,Concord High School,15885,1,0,1
7128,2013,Concord High School,15060,3,0,3
7129,2013,Concord High School,15140,7,3,4
7130,2013,Concord High School,15050,6,5,1
7131,2013,Concord High School,15210,1,1,0
7132,2013,Concord High School,15250,10,7,3
7133,2013,Concord High School,15020,1,0,1
7134,2013,St Leo's Catholic College,15240,3,0,3
7135,2013,St Leo's Catholic College,15340,1,1,0
7136,2013,St Leo's Catholic College,15170,1,1,0
7137,2013,St Leo's Catholic College,15230,3,3,0
7138,2013,St Leo's Catholic College,15120,1,1,0
7139,2013,St Leo's Catholic College,15320,1,1,0
7140,2013,St Leo's Catholic College,15350,1,0,1
7141,2013,St Leo's Catholic College,15200,1,1,0
7142,2013,St Leo's Catholic College,15380,4,2,2
7143,2013,St Leo's Catholic College,15160,1,1,0
7144,2013,St Leo's Catholic College,15110,1,1,0
7145,2013,St Leo's Catholic College,15030,5,2,3
7146,2013,St Leo's Catholic College,15370,2,0,2
7147,2013,St Leo's Catholic College,15400,3,1,2
7148,2013,St Leo's Catholic College,15100,1,0,1
7149,2013,St Leo's Catholic College,15040,3,2,1
7150,2013,St Leo's Catholic College,15050,5,3,2
7151,2013,St Leo's Catholic College,15250,4,2,2
7152,2013,St Leo's Catholic College,15220,1,1,0
7153,2013,St Leo's Catholic College,15020,4,1,3
7154,2013,Robert Townson High School,15170,1,1,0
7155,2013,Robert Townson High School,15230,2,1,1
7156,2013,Robert Townson High School,15200,1,1,0
7157,2013,Robert Townson High School,15160,1,1,0
7158,2013,Robert Townson High School,15030,1,0,1
7159,2013,Robert Townson High School,15400,1,0,1
7160,2013,Trinity Catholic College,15240,10,7,3
7161,2013,Trinity Catholic College,15270,5,2,3
7162,2013,Trinity Catholic College,15340,6,4,2
7163,2013,Trinity Catholic College,15170,2,0,2
7164,2013,Trinity Catholic College,15230,2,2,0
7165,2013,Trinity Catholic College,15090,2,0,2
7166,2013,Trinity Catholic College,15320,2,1,1
7167,2013,Trinity Catholic College,15280,9,7,2
7168,2013,Trinity Catholic College,15200,1,1,0
7169,2013,Trinity Catholic College,15160,1,0,1
7170,2013,Trinity Catholic College,15260,2,2,0
7171,2013,Trinity Catholic College,15030,3,1,2
7172,2013,Trinity Catholic College,15370,15,3,12
7173,2013,Trinity Catholic College,26599,5,1,4
7174,2013,Trinity Catholic College,15040,3,1,2
7175,2013,Trinity Catholic College,15800,1,0,1
7176,2013,Trinity Catholic College,15060,4,0,4
7177,2013,Trinity Catholic College,15140,5,2,3
7178,2013,Trinity Catholic College,15050,5,3,2
7179,2013,Trinity Catholic College,15290,2,0,2
7180,2013,Trinity Catholic College,15250,10,6,4
7181,2013,Trinity Catholic College,15220,2,0,2
7182,2013,Trinity Catholic College,15020,4,3,1
7183,2013,St Bishoy Coptic Orthodox College,15240,2,2,0
7184,2013,St Bishoy Coptic Orthodox College,15250,1,1,0
7185,2013,Covenant Christian School,15240,8,6,2
7186,2013,Covenant Christian School,15270,1,1,0
7187,2013,Covenant Christian School,15230,4,3,1
7188,2013,Covenant Christian School,15360,1,1,0
7189,2013,Covenant Christian School,15280,1,0,1
7190,2013,Covenant Christian School,15200,4,4,0
7191,2013,Covenant Christian School,15300,1,1,0
7192,2013,Covenant Christian School,15710,1,0,1
7193,2013,Covenant Christian School,15260,1,1,0
7194,2013,Covenant Christian School,15370,2,2,0
7195,2013,Covenant Christian School,15310,1,1,0
7196,2013,Covenant Christian School,26599,1,0,1
7197,2013,Covenant Christian School,15330,1,1,0
7198,2013,Covenant Christian School,15040,2,1,1
7199,2013,Covenant Christian School,15250,1,1,0
7200,2013,The Scots College,15240,13,13,0
7201,2013,The Scots College,15270,5,5,0
7202,2013,The Scots College,15170,4,4,0
7203,2013,The Scots College,15230,13,13,0
7204,2013,The Scots College,15190,1,1,0
7205,2013,The Scots College,15080,5,5,0
7206,2013,The Scots College,15090,9,9,0
7207,2013,The Scots College,15280,3,3,0
7208,2013,The Scots College,15380,3,3,0
7209,2013,The Scots College,15160,5,5,0
7210,2013,The Scots College,15300,3,3,0
7211,2013,The Scots College,15110,7,7,0
7212,2013,The Scots College,15765,1,1,0
7213,2013,The Scots College,15910,2,2,0
7214,2013,The Scots College,15680,2,2,0
7215,2013,The Scots College,15540,1,1,0
7216,2013,The Scots College,15260,7,5,2
7217,2013,The Scots College,15780,1,1,0
7218,2013,The Scots College,15900,1,1,0
7219,2013,The Scots College,15030,5,5,0
7220,2013,The Scots College,15370,3,3,0
7221,2013,The Scots College,15310,2,2,0
7222,2013,The Scots College,15330,7,6,1
7223,2013,The Scots College,15760,2,2,0
7224,2013,The Scots College,15400,3,3,0
7225,2013,The Scots College,15040,5,5,0
7226,2013,The Scots College,15140,15,15,0
7227,2013,The Scots College,15050,8,7,1
7228,2013,The Scots College,15250,26,23,3
7229,2013,The Scots College,15690,2,2,0
7230,2013,The Scots College,15220,1,1,0
7231,2013,Penrith Anglican College,15240,1,0,1
7232,2013,Penrith Anglican College,15230,3,2,1
7233,2013,Penrith Anglican College,15080,1,0,1
7234,2013,Penrith Anglican College,15360,1,1,0
7235,2013,Penrith Anglican College,15090,2,1,1
7236,2013,Penrith Anglican College,15320,1,1,0
7237,2013,Penrith Anglican College,15670,2,0,2
7238,2013,Penrith Anglican College,16070,1,1,0
7239,2013,Penrith Anglican College,15030,2,1,1
7240,2013,Penrith Anglican College,15310,1,1,0
7241,2013,Penrith Anglican College,15100,1,1,0
7242,2013,Penrith Anglican College,15040,4,3,1
7243,2013,Penrith Anglican College,15180,3,1,2
7244,2013,Penrith Anglican College,15290,3,2,1
7245,2013,Penrith Anglican College,15250,1,1,0
7246,2013,Penrith Anglican College,15220,2,0,2
7247,2013,Penrith Anglican College,15020,1,1,0
7248,2013,Penrith Anglican College,15390,3,0,3
7249,2013,Kirrawee High School,15240,5,1,4
7250,2013,Kirrawee High School,15230,1,0,1
7251,2013,Kirrawee High School,15070,6,0,6
7252,2013,Kirrawee High School,15720,1,0,1
7253,2013,Kirrawee High School,15090,5,2,3
7254,2013,Kirrawee High School,15320,5,3,2
7255,2013,Kirrawee High School,15350,1,1,0
7256,2013,Kirrawee High School,15110,1,0,1
7257,2013,Kirrawee High School,15260,1,1,0
7258,2013,Kirrawee High School,15030,3,1,2
7259,2013,Kirrawee High School,15310,5,3,2
7260,2013,Kirrawee High School,15400,4,1,3
7261,2013,Kirrawee High School,15040,2,0,2
7262,2013,Kirrawee High School,15060,4,1,3
7263,2013,Kirrawee High School,15140,3,1,2
7264,2013,Kirrawee High School,15130,1,0,1
7265,2013,Kirrawee High School,15050,1,0,1
7266,2013,Kirrawee High School,15210,1,1,0
7267,2013,Kirrawee High School,15290,2,2,0
7268,2013,Kirrawee High School,15250,1,1,0
7269,2013,Kirrawee High School,15220,2,0,2
7270,2013,Kirrawee High School,15020,1,1,0
7271,2013,Kirrawee High School,15390,3,0,3
7272,2013,Northern Beaches Secondary College Mackellar Girls Campus,15240,1,0,1
7273,2013,Northern Beaches Secondary College Mackellar Girls Campus,15270,5,1,4
7274,2013,Northern Beaches Secondary College Mackellar Girls Campus,15170,1,1,0
7275,2013,Northern Beaches Secondary College Mackellar Girls Campus,15230,4,0,4
7276,2013,Northern Beaches Secondary College Mackellar Girls Campus,15080,1,0,1
7277,2013,Northern Beaches Secondary College Mackellar Girls Campus,15070,3,1,2
7278,2013,Northern Beaches Secondary College Mackellar Girls Campus,15090,4,0,4
7279,2013,Northern Beaches Secondary College Mackellar Girls Campus,15320,4,0,4
7280,2013,Northern Beaches Secondary College Mackellar Girls Campus,15280,4,1,3
7281,2013,Northern Beaches Secondary College Mackellar Girls Campus,15350,11,1,10
7282,2013,Northern Beaches Secondary College Mackellar Girls Campus,15160,7,1,6
7283,2013,Northern Beaches Secondary College Mackellar Girls Campus,15300,1,0,1
7284,2013,Northern Beaches Secondary College Mackellar Girls Campus,15710,1,0,1
7285,2013,Northern Beaches Secondary College Mackellar Girls Campus,15560,2,0,2
7286,2013,Northern Beaches Secondary College Mackellar Girls Campus,15680,1,0,1
7287,2013,Northern Beaches Secondary College Mackellar Girls Campus,15260,1,0,1
7288,2013,Northern Beaches Secondary College Mackellar Girls Campus,15030,5,0,5
7289,2013,Northern Beaches Secondary College Mackellar Girls Campus,15310,3,0,3
7290,2013,Northern Beaches Secondary College Mackellar Girls Campus,26599,2,0,2
7291,2013,Northern Beaches Secondary College Mackellar Girls Campus,15400,3,0,3
7292,2013,Northern Beaches Secondary College Mackellar Girls Campus,15555,1,0,1
7293,2013,Northern Beaches Secondary College Mackellar Girls Campus,15040,2,0,2
7294,2013,Northern Beaches Secondary College Mackellar Girls Campus,15180,3,0,3
7295,2013,Northern Beaches Secondary College Mackellar Girls Campus,15140,25,1,24
7296,2013,Northern Beaches Secondary College Mackellar Girls Campus,15130,2,0,2
7297,2013,Northern Beaches Secondary College Mackellar Girls Campus,15050,3,0,3
7298,2013,Northern Beaches Secondary College Mackellar Girls Campus,15250,1,0,1
7299,2013,Northern Beaches Secondary College Mackellar Girls Campus,15220,5,0,5
7300,2013,Northern Beaches Secondary College Mackellar Girls Campus,15020,9,1,8
7301,2013,Northern Beaches Secondary College Mackellar Girls Campus,15390,1,0,1
7302,2013,Chatswood High School,15240,14,7,7
7303,2013,Chatswood High School,15270,2,1,1
7304,2013,Chatswood High School,15340,3,2,1
7305,2013,Chatswood High School,15230,7,5,2
7306,2013,Chatswood High School,15080,1,0,1
7307,2013,Chatswood High School,15830,1,1,0
7308,2013,Chatswood High School,15890,1,0,1
7309,2013,Chatswood High School,15090,1,1,0
7310,2013,Chatswood High School,15850,1,1,0
7311,2013,Chatswood High School,15320,1,0,1
7312,2013,Chatswood High School,15200,1,1,0
7313,2013,Chatswood High School,15380,1,1,0
7314,2013,Chatswood High School,15820,3,0,3
7315,2013,Chatswood High School,15300,5,1,4
7316,2013,Chatswood High School,15110,4,3,1
7317,2013,Chatswood High School,15560,3,2,1
7318,2013,Chatswood High School,15260,9,5,4
7319,2013,Chatswood High School,15030,5,2,3
7320,2013,Chatswood High School,15310,3,1,2
7321,2013,Chatswood High School,26599,3,1,2
7322,2013,Chatswood High School,15330,8,7,1
7323,2013,Chatswood High School,15150,1,0,1
7324,2013,Chatswood High School,15400,2,0,2
7325,2013,Chatswood High School,15040,8,5,3
7326,2013,Chatswood High School,15140,2,0,2
7327,2013,Chatswood High School,15050,7,6,1
7328,2013,Chatswood High School,15210,3,1,2
7329,2013,Chatswood High School,15250,16,10,6
7330,2013,Chatswood High School,15220,3,2,1
7331,2013,Chatswood High School,15020,1,0,1
7332,2013,Chatswood High School,15700,1,0,1
7333,2013,Killarney Heights High School,15240,8,7,1
7334,2013,Killarney Heights High School,15270,2,2,0
7335,2013,Killarney Heights High School,15340,1,1,0
7336,2013,Killarney Heights High School,15230,9,4,5
7337,2013,Killarney Heights High School,15120,2,2,0
7338,2013,Killarney Heights High School,15360,1,1,0
7339,2013,Killarney Heights High School,15320,1,1,0
7340,2013,Killarney Heights High School,15280,1,1,0
7341,2013,Killarney Heights High School,15350,1,1,0
7342,2013,Killarney Heights High School,15200,1,1,0
7343,2013,Killarney Heights High School,15560,2,0,2
7344,2013,Killarney Heights High School,15260,2,0,2
7345,2013,Killarney Heights High School,15790,1,0,1
7346,2013,Killarney Heights High School,26599,1,0,1
7347,2013,Killarney Heights High School,15150,1,0,1
7348,2013,Killarney Heights High School,15400,1,0,1
7349,2013,Killarney Heights High School,15040,1,0,1
7350,2013,Killarney Heights High School,15180,2,0,2
7351,2013,Killarney Heights High School,15835,1,0,1
7352,2013,Killarney Heights High School,15050,4,3,1
7353,2013,Killarney Heights High School,15290,1,1,0
7354,2013,Killarney Heights High School,15250,2,0,2
7355,2013,Killarney Heights High School,15690,1,1,0
7356,2013,Killarney Heights High School,15220,3,3,0
7357,2013,Killarney Heights High School,15020,1,1,0
7358,2013,All Saints' College Bathurst,15270,4,0,4
7359,2013,All Saints' College Bathurst,15080,2,1,1
7360,2013,All Saints' College Bathurst,15090,2,0,2
7361,2013,All Saints' College Bathurst,15160,1,0,1
7362,2013,All Saints' College Bathurst,15030,2,0,2
7363,2013,All Saints' College Bathurst,15330,1,0,1
7364,2013,All Saints' College Bathurst,15400,2,0,2
7365,2013,All Saints' College Bathurst,15140,3,0,3
7366,2013,All Saints' College Bathurst,15130,2,0,2
7367,2013,All Saints' College Bathurst,15050,1,0,1
7368,2013,All Saints' College Bathurst,15290,1,1,0
7369,2013,All Saints' College Bathurst,15220,1,0,1
7370,2013,Conservatorium High School,15240,3,1,2
7371,2013,Conservatorium High School,15230,2,0,2
7372,2013,Conservatorium High School,15670,1,0,1
7373,2013,Conservatorium High School,15300,16,9,7
7374,2013,Conservatorium High School,15310,16,5,11
7375,2013,Conservatorium High School,15140,2,0,2
7376,2013,Conservatorium High School,15250,1,1,0
7377,2013,Conservatorium High School,15020,2,0,2
7378,2013,Conservatorium High School,15700,3,0,3
7379,2013,Bellingen High School,15230,1,1,0
7380,2013,Bellingen High School,15190,1,1,0
7381,2013,Bellingen High School,15350,1,1,0
7382,2013,Bellingen High School,15200,3,3,0
7383,2013,Bellingen High School,15030,1,0,1
7384,2013,Bellingen High School,15310,1,0,1
7385,2013,Bellingen High School,15330,1,0,1
7386,2013,Bellingen High School,15140,1,0,1
7387,2013,Bellingen High School,15020,1,1,0
7388,2013,Oxley High School,15240,2,2,0
7389,2013,Oxley High School,15230,2,2,0
7390,2013,Oxley High School,15190,4,4,0
7391,2013,Oxley High School,15090,1,0,1
7392,2013,Oxley High School,15320,2,2,0
7393,2013,Oxley High School,15110,2,2,0
7394,2013,Oxley High School,15030,1,1,0
7395,2013,Oxley High School,15330,1,1,0
7396,2013,Oxley High School,15050,1,1,0
7397,2013,Oxley High School,15250,1,1,0
7398,2013,Oxley High School,15220,2,1,1
7399,2013,The McDonald College,15170,3,2,1
7400,2013,The McDonald College,15230,2,1,1
7401,2013,The McDonald College,15070,2,0,2
7402,2013,The McDonald College,15090,4,2,2
7403,2013,The McDonald College,15320,1,0,1
7404,2013,The McDonald College,15670,1,0,1
7405,2013,The McDonald College,15310,1,0,1
7406,2013,The McDonald College,15400,1,1,0
7407,2013,The McDonald College,15040,2,1,1
7408,2013,The McDonald College,15140,2,1,1
7409,2013,The McDonald College,15290,2,1,1
7410,2013,The McDonald College,15220,2,2,0
7411,2013,The McDonald College,15390,1,0,1
7412,2013,Abbotsleigh,15240,20,0,20
7413,2013,Abbotsleigh,15270,20,1,19
7414,2013,Abbotsleigh,15340,2,0,2
7415,2013,Abbotsleigh,15170,12,0,12
7416,2013,Abbotsleigh,15230,12,0,12
7417,2013,Abbotsleigh,15190,14,1,13
7418,2013,Abbotsleigh,15080,7,0,7
7419,2013,Abbotsleigh,15720,1,0,1
7420,2013,Abbotsleigh,15090,16,0,16
7421,2013,Abbotsleigh,15850,1,1,0
7422,2013,Abbotsleigh,15320,12,0,12
7423,2013,Abbotsleigh,15280,13,0,13
7424,2013,Abbotsleigh,15380,4,0,4
7425,2013,Abbotsleigh,15160,30,0,30
7426,2013,Abbotsleigh,15300,4,0,4
7427,2013,Abbotsleigh,15110,7,0,7
7428,2013,Abbotsleigh,15710,1,0,1
7429,2013,Abbotsleigh,15560,1,1,0
7430,2013,Abbotsleigh,15680,2,0,2
7431,2013,Abbotsleigh,15640,1,0,1
7432,2013,Abbotsleigh,15260,8,1,7
7433,2013,Abbotsleigh,15900,1,0,1
7434,2013,Abbotsleigh,15030,10,0,10
7435,2013,Abbotsleigh,15370,8,1,7
7436,2013,Abbotsleigh,15310,2,0,2
7437,2013,Abbotsleigh,15330,7,0,7
7438,2013,Abbotsleigh,15400,32,1,31
7439,2013,Abbotsleigh,15100,3,0,3
7440,2013,Abbotsleigh,15040,26,0,26
7441,2013,Abbotsleigh,15140,77,2,75
7442,2013,Abbotsleigh,15130,1,0,1
7443,2013,Abbotsleigh,15050,11,0,11
7444,2013,Abbotsleigh,15290,7,0,7
7445,2013,Abbotsleigh,15250,22,2,20
7446,2013,Abbotsleigh,15690,3,0,3
7447,2013,Abbotsleigh,15020,13,0,13
7448,2013,St Paul's Catholic College,15240,9,9,0
7449,2013,St Paul's Catholic College,15270,3,2,1
7450,2013,St Paul's Catholic College,15340,1,1,0
7451,2013,St Paul's Catholic College,15170,1,1,0
7452,2013,St Paul's Catholic College,15230,3,3,0
7453,2013,St Paul's Catholic College,15360,1,1,0
7454,2013,St Paul's Catholic College,15320,2,2,0
7455,2013,St Paul's Catholic College,15380,1,1,0
7456,2013,St Paul's Catholic College,15160,1,1,0
7457,2013,St Paul's Catholic College,15110,3,3,0
7458,2013,St Paul's Catholic College,15260,3,2,1
7459,2013,St Paul's Catholic College,15370,1,1,0
7460,2013,St Paul's Catholic College,15330,2,2,0
7461,2013,St Paul's Catholic College,15400,1,1,0
7462,2013,St Paul's Catholic College,15040,1,1,0
7463,2013,St Paul's Catholic College,15140,3,2,1
7464,2013,St Paul's Catholic College,15050,1,1,0
7465,2013,St Paul's Catholic College,15210,1,1,0
7466,2013,St Paul's Catholic College,15290,1,1,0
7467,2013,St Paul's Catholic College,15250,7,6,1
7468,2013,St Paul's Catholic College,15220,2,2,0
7469,2013,St Paul's Catholic College,15020,2,1,1
7470,2013,Caroline Chisholm College,15240,1,0,1
7471,2013,Caroline Chisholm College,15270,5,0,5
7472,2013,Caroline Chisholm College,15340,3,0,3
7473,2013,Caroline Chisholm College,15230,2,0,2
7474,2013,Caroline Chisholm College,15090,1,0,1
7475,2013,Caroline Chisholm College,15320,1,0,1
7476,2013,Caroline Chisholm College,15350,4,0,4
7477,2013,Caroline Chisholm College,15380,1,0,1
7478,2013,Caroline Chisholm College,15160,1,0,1
7479,2013,Caroline Chisholm College,15030,1,0,1
7480,2013,Caroline Chisholm College,15370,5,0,5
7481,2013,Caroline Chisholm College,26599,1,0,1
7482,2013,Caroline Chisholm College,15400,14,1,13
7483,2013,Caroline Chisholm College,15040,1,0,1
7484,2013,Caroline Chisholm College,15180,1,0,1
7485,2013,Caroline Chisholm College,15060,3,0,3
7486,2013,Caroline Chisholm College,15140,5,0,5
7487,2013,Caroline Chisholm College,15220,12,0,12
7488,2013,Caroline Chisholm College,15020,1,0,1
7489,2013,Pittwater High School,15240,2,1,1
7490,2013,Pittwater High School,15340,2,1,1
7491,2013,Pittwater High School,15320,2,1,1
7492,2013,Pittwater High School,15030,2,1,1
7493,2013,Pittwater High School,15310,2,2,0
7494,2013,Pittwater High School,26599,3,1,2
7495,2013,Pittwater High School,15330,1,0,1
7496,2013,Pittwater High School,16100,1,1,0
7497,2013,Pittwater High School,15180,2,0,2
7498,2013,Pittwater High School,15060,1,0,1
7499,2013,Pittwater High School,15140,1,1,0
7500,2013,Pittwater High School,15050,1,0,1
7501,2013,Pittwater High School,15290,2,2,0
7502,2013,Pittwater High School,15250,3,1,2
7503,2013,Pittwater High School,15220,2,1,1
7504,2013,Pittwater High School,15390,1,0,1
7505,2013,Crookwell High School,15200,1,0,1
7506,2013,Crookwell High School,26599,1,1,0
7507,2013,Crookwell High School,15040,1,1,0
7508,2013,Southern Highlands Christian School,15230,1,0,1
7509,2013,Southern Highlands Christian School,15790,1,0,1
7510,2013,St Ignatius' College,15240,32,32,0
7511,2013,St Ignatius' College,15270,8,8,0
7512,2013,St Ignatius' College,15170,4,4,0
7513,2013,St Ignatius' College,15230,32,32,0
7514,2013,St Ignatius' College,15190,1,1,0
7515,2013,St Ignatius' College,15120,4,4,0
7516,2013,St Ignatius' College,15090,3,3,0
7517,2013,St Ignatius' College,15550,3,3,0
7518,2013,St Ignatius' College,15320,4,4,0
7519,2013,St Ignatius' College,15280,3,3,0
7520,2013,St Ignatius' College,15200,11,11,0
7521,2013,St Ignatius' College,15380,11,11,0
7522,2013,St Ignatius' College,15160,7,7,0
7523,2013,St Ignatius' College,15300,4,4,0
7524,2013,St Ignatius' College,15110,21,21,0
7525,2013,St Ignatius' College,15910,2,2,0
7526,2013,St Ignatius' College,15680,3,3,0
7527,2013,St Ignatius' College,15260,8,8,0
7528,2013,St Ignatius' College,15570,3,3,0
7529,2013,St Ignatius' College,15000,1,1,0
7530,2013,St Ignatius' College,15900,1,1,0
7531,2013,St Ignatius' College,15030,3,3,0
7532,2013,St Ignatius' College,15370,16,16,0
7533,2013,St Ignatius' College,15310,3,3,0
7534,2013,St Ignatius' College,15810,1,1,0
7535,2013,St Ignatius' College,15330,4,4,0
7536,2013,St Ignatius' College,15400,6,6,0
7537,2013,St Ignatius' College,15040,24,24,0
7538,2013,St Ignatius' College,15140,43,43,0
7539,2013,St Ignatius' College,15050,8,8,0
7540,2013,St Ignatius' College,15210,6,6,0
7541,2013,St Ignatius' College,15290,3,3,0
7542,2013,St Ignatius' College,15250,17,17,0
7543,2013,St Ignatius' College,15690,3,3,0
7544,2013,St Ignatius' College,15010,1,1,0
7545,2013,Kurri Kurri High School,15020,1,0,1
7546,2013,Doonside High School,15340,1,1,0
7547,2013,Doonside High School,15230,1,0,1
7548,2013,Doonside High School,15030,1,0,1
7549,2013,Doonside High School,15060,1,0,1
7550,2013,Tyndale Christian School,15240,1,1,0
7551,2013,Tyndale Christian School,15270,1,0,1
7552,2013,Tyndale Christian School,15230,1,1,0
7553,2013,Tyndale Christian School,15350,2,1,1
7554,2013,Mudgee High School,15240,2,2,0
7555,2013,Mudgee High School,15320,5,2,3
7556,2013,Mudgee High School,15030,3,2,1
7557,2013,Mudgee High School,15400,6,0,6
7558,2013,Mudgee High School,15040,1,1,0
7559,2013,Mudgee High School,15060,2,1,1
7560,2013,Mudgee High School,15140,2,0,2
7561,2013,Mudgee High School,15250,1,1,0
7562,2013,Mudgee High School,15220,2,1,1
7563,2013,Mudgee High School,15390,3,2,1
7564,2013,Moorefield Girls High School,15040,1,0,1
7565,2013,Boorowa Central School,15240,1,1,0
7566,2013,St Andrews College,15240,4,4,0
7567,2013,St Andrews College,15270,2,1,1
7568,2013,St Andrews College,15340,2,1,1
7569,2013,St Andrews College,15230,7,5,2
7570,2013,St Andrews College,15320,1,0,1
7571,2013,St Andrews College,15670,2,1,1
7572,2013,St Andrews College,15350,2,0,2
7573,2013,St Andrews College,15380,3,1,2
7574,2013,St Andrews College,15160,1,0,1
7575,2013,St Andrews College,15260,1,1,0
7576,2013,St Andrews College,15030,1,1,0
7577,2013,St Andrews College,15370,4,1,3
7578,2013,St Andrews College,26599,3,1,2
7579,2013,St Andrews College,15040,1,0,1
7580,2013,St Andrews College,15060,1,0,1
7581,2013,St Andrews College,15140,1,0,1
7582,2013,St Andrews College,15250,5,5,0
7583,2013,St Andrews College,15220,3,1,2
7584,2013,Australian International School Singapore,15240,4,3,1
7585,2013,Australian International School Singapore,15270,1,1,0
7586,2013,Australian International School Singapore,15230,4,2,2
7587,2013,Australian International School Singapore,15360,1,1,0
7588,2013,Australian International School Singapore,15090,1,0,1
7589,2013,Australian International School Singapore,15550,1,1,0
7590,2013,Australian International School Singapore,15280,1,0,1
7591,2013,Australian International School Singapore,15030,1,1,0
7592,2013,Australian International School Singapore,15400,2,0,2
7593,2013,Australian International School Singapore,15040,5,2,3
7594,2013,Australian International School Singapore,15140,2,0,2
7595,2013,Australian International School Singapore,15210,2,2,0
7596,2013,Australian International School Singapore,15290,2,1,1
7597,2013,Australian International School Singapore,15250,1,1,0
7598,2013,Australian International School Singapore,15220,1,0,1
7599,2013,Australian International School Singapore,15020,3,2,1
7600,2013,Brisbane Water Secondary College Woy Woy Campus,15240,2,2,0
7601,2013,Brisbane Water Secondary College Woy Woy Campus,15170,1,0,1
7602,2013,Brisbane Water Secondary College Woy Woy Campus,15120,1,1,0
7603,2013,Brisbane Water Secondary College Woy Woy Campus,15320,1,0,1
7604,2013,Brisbane Water Secondary College Woy Woy Campus,15160,1,0,1
7605,2013,Brisbane Water Secondary College Woy Woy Campus,15030,2,2,0
7606,2013,Brisbane Water Secondary College Woy Woy Campus,15400,2,0,2
7607,2013,Brisbane Water Secondary College Woy Woy Campus,15140,1,0,1
7608,2013,Brisbane Water Secondary College Woy Woy Campus,15050,1,1,0
7609,2013,Brisbane Water Secondary College Woy Woy Campus,15250,2,2,0
7610,2013,Brisbane Water Secondary College Woy Woy Campus,15220,1,0,1
7611,2013,Brisbane Water Secondary College Woy Woy Campus,15020,2,0,2
7612,2013,Blacktown Girls High School,15670,1,0,1
7613,2013,St Mark's Coptic Orthodox College,15240,7,2,5
7614,2013,St Mark's Coptic Orthodox College,15230,2,0,2
7615,2013,St Mark's Coptic Orthodox College,15320,1,1,0
7616,2013,St Mark's Coptic Orthodox College,15260,7,6,1
7617,2013,St Mark's Coptic Orthodox College,15030,2,1,1
7618,2013,St Mark's Coptic Orthodox College,15370,2,2,0
7619,2013,St Mark's Coptic Orthodox College,15140,1,0,1
7620,2013,St Mark's Coptic Orthodox College,15050,2,2,0
7621,2013,St Mark's Coptic Orthodox College,15250,11,6,5
7622,2013,St Joseph's Catholic High School,15340,1,0,1
7623,2013,St Joseph's Catholic High School,15080,1,0,1
7624,2013,St Joseph's Catholic High School,15090,2,1,1
7625,2013,St Joseph's Catholic High School,15320,3,0,3
7626,2013,St Joseph's Catholic High School,16070,1,0,1
7627,2013,St Joseph's Catholic High School,15380,1,0,1
7628,2013,St Joseph's Catholic High School,15370,3,1,2
7629,2013,St Joseph's Catholic High School,15400,2,0,2
7630,2013,St Joseph's Catholic High School,15060,2,1,1
7631,2013,St Joseph's Catholic High School,15290,4,2,2
7632,2013,St Joseph's Catholic High School,15220,2,0,2
7633,2013,Cumberland High School,15240,1,0,1
7634,2013,Cumberland High School,15230,1,1,0
7635,2013,Cumberland High School,15320,1,0,1
7636,2013,Cumberland High School,15560,1,0,1
7637,2013,Cumberland High School,15210,1,0,1
7638,2013,Cumberland High School,15250,3,1,2
7639,2013,Cumberland High School,15020,1,1,0
7640,2013,Vincentia High School,15230,1,1,0
7641,2013,Vincentia High School,15200,1,1,0
7642,2013,Vincentia High School,15040,1,0,1
7643,2013,Vincentia High School,26099,1,0,1
7644,2013,Vincentia High School,15220,1,0,1
7645,2013,Wauchope High School,15240,2,1,1
7646,2013,Wauchope High School,15340,1,0,1
7647,2013,Wauchope High School,15320,1,0,1
7648,2013,Wauchope High School,15030,2,0,2
7649,2013,Wauchope High School,15060,1,0,1
7650,2013,Wauchope High School,15050,1,0,1
7651,2013,Wauchope High School,15250,1,0,1
7652,2013,Wauchope High School,15010,1,0,1
7653,2013,Mitchell High School,15240,1,1,0
7654,2013,Mitchell High School,15230,6,3,3
7655,2013,Mitchell High School,15280,1,0,1
7656,2013,Mitchell High School,15670,3,1,2
7657,2013,Mitchell High School,15350,1,1,0
7658,2013,Mitchell High School,15030,1,0,1
7659,2013,Mitchell High School,15330,1,0,1
7660,2013,Mitchell High School,15060,1,0,1
7661,2013,Mitchell High School,15140,1,0,1
7662,2013,Mitchell High School,15210,1,1,0
7663,2013,Mitchell High School,15250,3,2,1
7664,2013,Mitchell High School,15020,1,0,1
7665,2013,Coleambally Central School,26099,1,1,0
7666,2013,Gulgong High School,15020,2,0,2
7667,2013,Cranebrook High School,15030,1,0,1
7668,2013,St Patrick's Marist College,15240,21,16,5
7669,2013,St Patrick's Marist College,15270,1,1,0
7670,2013,St Patrick's Marist College,15340,3,3,0
7671,2013,St Patrick's Marist College,15230,13,6,7
7672,2013,St Patrick's Marist College,15850,1,1,0
7673,2013,St Patrick's Marist College,15320,1,0,1
7674,2013,St Patrick's Marist College,15200,4,4,0
7675,2013,St Patrick's Marist College,15380,3,0,3
7676,2013,St Patrick's Marist College,15710,1,0,1
7677,2013,St Patrick's Marist College,15260,3,1,2
7678,2013,St Patrick's Marist College,15370,6,2,4
7679,2013,St Patrick's Marist College,26599,1,0,1
7680,2013,St Patrick's Marist College,15330,1,1,0
7681,2013,St Patrick's Marist College,15400,3,0,3
7682,2013,St Patrick's Marist College,15040,7,4,3
7683,2013,St Patrick's Marist College,15180,1,0,1
7684,2013,St Patrick's Marist College,15050,4,2,2
7685,2013,St Patrick's Marist College,15290,1,0,1
7686,2013,St Patrick's Marist College,15250,9,5,4
7687,2013,St Patrick's Marist College,15220,2,1,1
7688,2013,Hunter Sports High School,26599,1,0,1
7689,2013,Hunter Sports High School,15290,1,1,0
7690,2013,Bomaderry High School,15240,1,1,0
7691,2013,Bomaderry High School,15140,1,1,0
7692,2013,Bomaderry High School,15020,1,0,1
7693,2013,Kyogle High School,15180,1,0,1
7694,2013,Great Lakes College Senior Campus,15240,2,2,0
7695,2013,Great Lakes College Senior Campus,15340,5,2,3
7696,2013,Great Lakes College Senior Campus,15230,2,0,2
7697,2013,Great Lakes College Senior Campus,15080,1,1,0
7698,2013,Great Lakes College Senior Campus,15350,1,0,1
7699,2013,Great Lakes College Senior Campus,15200,1,1,0
7700,2013,Great Lakes College Senior Campus,15260,2,1,1
7701,2013,Great Lakes College Senior Campus,26599,2,1,1
7702,2013,Great Lakes College Senior Campus,15330,3,3,0
7703,2013,Great Lakes College Senior Campus,15400,1,0,1
7704,2013,Great Lakes College Senior Campus,15100,1,1,0
7705,2013,Great Lakes College Senior Campus,15040,1,1,0
7706,2013,Great Lakes College Senior Campus,15180,2,0,2
7707,2013,Great Lakes College Senior Campus,15050,3,2,1
7708,2013,Great Lakes College Senior Campus,15290,1,1,0
7709,2013,Great Lakes College Senior Campus,15250,2,1,1
7710,2013,Loreto Kirribilli,15240,19,0,19
7711,2013,Loreto Kirribilli,15270,4,0,4
7712,2013,Loreto Kirribilli,15230,17,0,17
7713,2013,Loreto Kirribilli,15190,4,0,4
7714,2013,Loreto Kirribilli,15080,6,0,6
7715,2013,Loreto Kirribilli,15090,4,0,4
7716,2013,Loreto Kirribilli,15320,1,0,1
7717,2013,Loreto Kirribilli,15280,1,0,1
7718,2013,Loreto Kirribilli,15380,14,0,14
7719,2013,Loreto Kirribilli,15160,9,0,9
7720,2013,Loreto Kirribilli,15300,3,0,3
7721,2013,Loreto Kirribilli,15110,4,0,4
7722,2013,Loreto Kirribilli,15260,3,0,3
7723,2013,Loreto Kirribilli,15030,4,0,4
7724,2013,Loreto Kirribilli,15370,44,1,43
7725,2013,Loreto Kirribilli,15310,2,0,2
7726,2013,Loreto Kirribilli,15810,2,0,2
7727,2013,Loreto Kirribilli,26599,5,0,5
7728,2013,Loreto Kirribilli,15330,2,0,2
7729,2013,Loreto Kirribilli,15400,20,0,20
7730,2013,Loreto Kirribilli,15040,14,1,13
7731,2013,Loreto Kirribilli,15800,8,0,8
7732,2013,Loreto Kirribilli,15180,4,0,4
7733,2013,Loreto Kirribilli,15140,28,0,28
7734,2013,Loreto Kirribilli,15050,9,0,9
7735,2013,Loreto Kirribilli,15290,4,0,4
7736,2013,Loreto Kirribilli,15250,9,0,9
7737,2013,Loreto Kirribilli,15220,15,0,15
7738,2013,Loreto Kirribilli,15020,8,0,8
7739,2013,South Western Sydney Institute - Bankstown Campus,15330,1,1,0
7740,2013,South Western Sydney Institute - Bankstown Campus,15050,1,1,0
7741,2013,South Western Sydney Institute - Bankstown Campus,15250,1,1,0
7742,2013,South Western Sydney Institute - Bankstown Campus,15220,1,0,1
7743,2013,Christadelphian Heritage College,15240,1,1,0
7744,2013,Christadelphian Heritage College,15140,2,2,0
7745,2013,Christadelphian Heritage College,15050,2,2,0
7746,2013,Coffs Harbour High School,15340,1,0,1
7747,2013,Coffs Harbour High School,26599,1,0,1
7748,2013,Coffs Harbour High School,15390,1,0,1
7749,2013,Mount St Joseph Milperra,15240,3,0,3
7750,2013,Mount St Joseph Milperra,15270,4,0,4
7751,2013,Mount St Joseph Milperra,15170,1,0,1
7752,2013,Mount St Joseph Milperra,15230,6,0,6
7753,2013,Mount St Joseph Milperra,15080,1,0,1
7754,2013,Mount St Joseph Milperra,15320,3,0,3
7755,2013,Mount St Joseph Milperra,15280,5,0,5
7756,2013,Mount St Joseph Milperra,15350,9,0,9
7757,2013,Mount St Joseph Milperra,15380,1,0,1
7758,2013,Mount St Joseph Milperra,15160,1,0,1
7759,2013,Mount St Joseph Milperra,15110,1,0,1
7760,2013,Mount St Joseph Milperra,15030,8,1,7
7761,2013,Mount St Joseph Milperra,15370,12,0,12
7762,2013,Mount St Joseph Milperra,26599,2,0,2
7763,2013,Mount St Joseph Milperra,15330,1,0,1
7764,2013,Mount St Joseph Milperra,15400,4,0,4
7765,2013,Mount St Joseph Milperra,15040,2,0,2
7766,2013,Mount St Joseph Milperra,26199,4,0,4
7767,2013,Mount St Joseph Milperra,15800,2,0,2
7768,2013,Mount St Joseph Milperra,15180,1,0,1
7769,2013,Mount St Joseph Milperra,15140,8,0,8
7770,2013,Mount St Joseph Milperra,15130,3,0,3
7771,2013,Mount St Joseph Milperra,15250,3,0,3
7772,2013,Mount St Joseph Milperra,15220,5,0,5
7773,2013,Mount St Joseph Milperra,15020,1,0,1
7774,2013,Mount St Joseph Milperra,15390,1,0,1
7775,2013,Holy Cross College,15170,1,1,0
7776,2013,Holy Cross College,15230,2,2,0
7777,2013,Holy Cross College,15200,1,1,0
7778,2013,Holy Cross College,15260,1,1,0
7779,2013,Holy Cross College,15620,1,1,0
7780,2013,Holy Cross College,15330,1,1,0
7781,2013,Holy Cross College,15050,1,1,0
7782,2013,Holy Cross College,15250,1,1,0
7783,2013,Marist College Kogarah,15240,9,9,0
7784,2013,Marist College Kogarah,15270,6,6,0
7785,2013,Marist College Kogarah,15340,2,2,0
7786,2013,Marist College Kogarah,15230,18,18,0
7787,2013,Marist College Kogarah,15080,1,1,0
7788,2013,Marist College Kogarah,15120,3,3,0
7789,2013,Marist College Kogarah,15320,5,5,0
7790,2013,Marist College Kogarah,15280,3,3,0
7791,2013,Marist College Kogarah,15200,7,7,0
7792,2013,Marist College Kogarah,15380,4,4,0
7793,2013,Marist College Kogarah,15110,1,1,0
7794,2013,Marist College Kogarah,15030,2,2,0
7795,2013,Marist College Kogarah,15370,6,6,0
7796,2013,Marist College Kogarah,15330,3,3,0
7797,2013,Marist College Kogarah,15040,3,3,0
7798,2013,Marist College Kogarah,15800,1,1,0
7799,2013,Marist College Kogarah,15140,11,11,0
7800,2013,Marist College Kogarah,15130,7,7,0
7801,2013,Marist College Kogarah,15050,3,3,0
7802,2013,Marist College Kogarah,15210,1,1,0
7803,2013,Marist College Kogarah,15290,3,3,0
7804,2013,Marist College Kogarah,15250,4,4,0
7805,2013,Marist College Kogarah,15220,6,6,0
7806,2013,Marist College Kogarah,15020,2,2,0
7807,2013,Asquith Girls High School,15240,2,0,2
7808,2013,Asquith Girls High School,15270,1,0,1
7809,2013,Asquith Girls High School,15340,1,0,1
7810,2013,Asquith Girls High School,15170,3,0,3
7811,2013,Asquith Girls High School,15230,5,0,5
7812,2013,Asquith Girls High School,15320,1,0,1
7813,2013,Asquith Girls High School,15280,1,0,1
7814,2013,Asquith Girls High School,15670,1,0,1
7815,2013,Asquith Girls High School,15350,2,0,2
7816,2013,Asquith Girls High School,15820,1,0,1
7817,2013,Asquith Girls High School,15160,2,0,2
7818,2013,Asquith Girls High School,15560,1,1,0
7819,2013,Asquith Girls High School,15260,1,1,0
7820,2013,Asquith Girls High School,27099,1,0,1
7821,2013,Asquith Girls High School,15030,1,0,1
7822,2013,Asquith Girls High School,15790,1,0,1
7823,2013,Asquith Girls High School,15310,3,0,3
7824,2013,Asquith Girls High School,15400,5,0,5
7825,2013,Asquith Girls High School,15140,4,0,4
7826,2013,Asquith Girls High School,15290,6,0,6
7827,2013,Asquith Girls High School,15250,2,1,1
7828,2013,Asquith Girls High School,15220,1,0,1
7829,2013,Asquith Girls High School,15020,1,0,1
7830,2013,Asquith Girls High School,15390,1,0,1
7831,2013,Kogarah High School,15240,2,0,2
7832,2013,Kogarah High School,15120,1,0,1
7833,2013,Kogarah High School,15560,1,0,1
7834,2013,Kogarah High School,15260,3,2,1
7835,2013,Kogarah High School,15330,2,1,1
7836,2013,Kogarah High School,15250,4,2,2
7837,2013,Macarthur Girls High School,15240,9,0,9
7838,2013,Macarthur Girls High School,26999,1,0,1
7839,2013,Macarthur Girls High School,15230,2,0,2
7840,2013,Macarthur Girls High School,15830,2,1,1
7841,2013,Macarthur Girls High School,15850,1,0,1
7842,2013,Macarthur Girls High School,15320,1,0,1
7843,2013,Macarthur Girls High School,16110,1,0,1
7844,2013,Macarthur Girls High School,15350,11,0,11
7845,2013,Macarthur Girls High School,15200,2,0,2
7846,2013,Macarthur Girls High School,15820,1,1,0
7847,2013,Macarthur Girls High School,15160,3,0,3
7848,2013,Macarthur Girls High School,15110,1,0,1
7849,2013,Macarthur Girls High School,15560,1,0,1
7850,2013,Macarthur Girls High School,15260,1,0,1
7851,2013,Macarthur Girls High School,15030,3,0,3
7852,2013,Macarthur Girls High School,15330,1,0,1
7853,2013,Macarthur Girls High School,15150,1,0,1
7854,2013,Macarthur Girls High School,15400,2,0,2
7855,2013,Macarthur Girls High School,15040,2,0,2
7856,2013,Macarthur Girls High School,15060,5,0,5
7857,2013,Macarthur Girls High School,15140,4,0,4
7858,2013,Macarthur Girls High School,15130,2,0,2
7859,2013,Macarthur Girls High School,15050,5,0,5
7860,2013,Macarthur Girls High School,15290,1,0,1
7861,2013,Macarthur Girls High School,15250,5,0,5
7862,2013,Macarthur Girls High School,15220,5,0,5
7863,2013,Macarthur Girls High School,15020,3,0,3
7864,2013,Kincoppal - Rose Bay School of the Sacred Heart,15240,9,0,9
7865,2013,Kincoppal - Rose Bay School of the Sacred Heart,15270,2,0,2
7866,2013,Kincoppal - Rose Bay School of the Sacred Heart,15170,1,0,1
7867,2013,Kincoppal - Rose Bay School of the Sacred Heart,15320,1,0,1
7868,2013,Kincoppal - Rose Bay School of the Sacred Heart,15280,4,0,4
7869,2013,Kincoppal - Rose Bay School of the Sacred Heart,15380,7,0,7
7870,2013,Kincoppal - Rose Bay School of the Sacred Heart,15820,1,0,1
7871,2013,Kincoppal - Rose Bay School of the Sacred Heart,15160,7,0,7
7872,2013,Kincoppal - Rose Bay School of the Sacred Heart,15110,1,0,1
7873,2013,Kincoppal - Rose Bay School of the Sacred Heart,15680,4,0,4
7874,2013,Kincoppal - Rose Bay School of the Sacred Heart,15370,4,0,4
7875,2013,Kincoppal - Rose Bay School of the Sacred Heart,15330,1,0,1
7876,2013,Kincoppal - Rose Bay School of the Sacred Heart,15150,1,1,0
7877,2013,Kincoppal - Rose Bay School of the Sacred Heart,15400,9,0,9
7878,2013,Kincoppal - Rose Bay School of the Sacred Heart,15040,5,0,5
7879,2013,Kincoppal - Rose Bay School of the Sacred Heart,15140,8,0,8
7880,2013,Kincoppal - Rose Bay School of the Sacred Heart,15290,2,0,2
7881,2013,Kincoppal - Rose Bay School of the Sacred Heart,15250,10,1,9
7882,2013,Kincoppal - Rose Bay School of the Sacred Heart,15690,2,0,2
7883,2013,Kincoppal - Rose Bay School of the Sacred Heart,15020,3,0,3
7884,2013,Menai High School,15240,3,1,2
7885,2013,Menai High School,15270,1,0,1
7886,2013,Menai High School,15230,2,2,0
7887,2013,Menai High School,15280,3,0,3
7888,2013,Menai High School,15350,2,1,1
7889,2013,Menai High School,15200,5,5,0
7890,2013,Menai High School,15820,2,0,2
7891,2013,Menai High School,15160,3,0,3
7892,2013,Menai High School,26699,1,1,0
7893,2013,Menai High School,15370,1,0,1
7894,2013,Menai High School,26599,2,0,2
7895,2013,Menai High School,15400,2,0,2
7896,2013,Menai High School,15040,1,1,0
7897,2013,Menai High School,15060,2,1,1
7898,2013,Menai High School,15140,9,1,8
7899,2013,Menai High School,15130,3,1,2
7900,2013,Menai High School,15210,2,2,0
7901,2013,Menai High School,15290,4,2,2
7902,2013,Menai High School,15250,2,1,1
7903,2013,Menai High School,15020,1,0,1
7904,2013,Mount St Benedict College,15240,7,0,7
7905,2013,Mount St Benedict College,15270,4,0,4
7906,2013,Mount St Benedict College,15340,2,0,2
7907,2013,Mount St Benedict College,15230,12,0,12
7908,2013,Mount St Benedict College,15190,2,0,2
7909,2013,Mount St Benedict College,15080,1,0,1
7910,2013,Mount St Benedict College,15320,8,0,8
7911,2013,Mount St Benedict College,15280,1,0,1
7912,2013,Mount St Benedict College,15350,7,0,7
7913,2013,Mount St Benedict College,15200,3,0,3
7914,2013,Mount St Benedict College,15380,13,0,13
7915,2013,Mount St Benedict College,15160,3,1,2
7916,2013,Mount St Benedict College,15110,2,0,2
7917,2013,Mount St Benedict College,15680,1,0,1
7918,2013,Mount St Benedict College,15030,4,0,4
7919,2013,Mount St Benedict College,15370,18,1,17
7920,2013,Mount St Benedict College,26599,1,0,1
7921,2013,Mount St Benedict College,15400,2,0,2
7922,2013,Mount St Benedict College,15040,5,0,5
7923,2013,Mount St Benedict College,15180,3,0,3
7924,2013,Mount St Benedict College,15060,2,0,2
7925,2013,Mount St Benedict College,15140,12,0,12
7926,2013,Mount St Benedict College,15130,2,0,2
7927,2013,Mount St Benedict College,15050,3,0,3
7928,2013,Mount St Benedict College,15250,1,0,1
7929,2013,Mount St Benedict College,15220,6,0,6
7930,2013,Mount St Benedict College,15020,6,0,6
7931,2013,Gloucester High School,15270,1,0,1
7932,2013,Gloucester High School,15030,1,0,1
7933,2013,Gloucester High School,15290,1,0,1
7934,2013,Gloucester High School,15020,1,0,1
7935,2013,MLC School,15240,8,0,8
7936,2013,MLC School,15270,4,0,4
7937,2013,MLC School,26499,2,0,2
7938,2013,MLC School,15170,2,0,2
7939,2013,MLC School,15230,4,0,4
7940,2013,MLC School,15190,2,0,2
7941,2013,MLC School,15080,1,0,1
7942,2013,MLC School,15830,1,0,1
7943,2013,MLC School,15090,3,0,3
7944,2013,MLC School,15850,1,0,1
7945,2013,MLC School,15320,6,0,6
7946,2013,MLC School,15280,2,0,2
7947,2013,MLC School,15380,6,0,6
7948,2013,MLC School,15820,3,0,3
7949,2013,MLC School,15160,9,0,9
7950,2013,MLC School,15300,5,0,5
7951,2013,MLC School,15710,1,0,1
7952,2013,MLC School,15560,1,0,1
7953,2013,MLC School,15260,2,0,2
7954,2013,MLC School,15900,1,0,1
7955,2013,MLC School,15030,6,0,6
7956,2013,MLC School,15370,4,0,4
7957,2013,MLC School,15790,1,0,1
7958,2013,MLC School,15310,4,0,4
7959,2013,MLC School,26599,3,0,3
7960,2013,MLC School,15970,1,0,1
7961,2013,MLC School,15400,5,0,5
7962,2013,MLC School,15040,5,0,5
7963,2013,MLC School,15140,29,1,28
7964,2013,MLC School,15050,5,0,5
7965,2013,MLC School,15290,2,0,2
7966,2013,MLC School,15250,8,0,8
7967,2013,MLC School,15020,4,0,4
7968,2013,MLC School,15390,2,0,2
7969,2013,St Mary's College,15240,1,1,0
7970,2013,St Mary's College,15290,1,1,0
7971,2013,"De La Salle Catholic College, Cronulla",15240,6,4,2
7972,2013,"De La Salle Catholic College, Cronulla",15270,1,0,1
7973,2013,"De La Salle Catholic College, Cronulla",15340,7,6,1
7974,2013,"De La Salle Catholic College, Cronulla",15230,21,11,10
7975,2013,"De La Salle Catholic College, Cronulla",15190,2,0,2
7976,2013,"De La Salle Catholic College, Cronulla",15080,3,0,3
7977,2013,"De La Salle Catholic College, Cronulla",15360,1,1,0
7978,2013,"De La Salle Catholic College, Cronulla",15320,5,2,3
7979,2013,"De La Salle Catholic College, Cronulla",15280,3,1,2
7980,2013,"De La Salle Catholic College, Cronulla",15380,5,1,4
7981,2013,"De La Salle Catholic College, Cronulla",15160,2,0,2
7982,2013,"De La Salle Catholic College, Cronulla",15110,2,1,1
7983,2013,"De La Salle Catholic College, Cronulla",15370,16,5,11
7984,2013,"De La Salle Catholic College, Cronulla",26599,3,1,2
7985,2013,"De La Salle Catholic College, Cronulla",15400,7,1,6
7986,2013,"De La Salle Catholic College, Cronulla",15040,6,3,3
7987,2013,"De La Salle Catholic College, Cronulla",15800,1,0,1
7988,2013,"De La Salle Catholic College, Cronulla",15060,5,0,5
7989,2013,"De La Salle Catholic College, Cronulla",15140,3,0,3
7990,2013,"De La Salle Catholic College, Cronulla",15210,3,2,1
7991,2013,"De La Salle Catholic College, Cronulla",15290,1,0,1
7992,2013,"De La Salle Catholic College, Cronulla",15250,2,2,0
7993,2013,"De La Salle Catholic College, Cronulla",15740,1,1,0
7994,2013,"De La Salle Catholic College, Cronulla",15220,13,5,8
7995,2013,"De La Salle Catholic College, Cronulla",15020,7,2,5
7996,2013,Sapphire Coast Anglican College,15240,1,1,0
7997,2013,Whitebridge High School,15240,1,1,0
7998,2013,Whitebridge High School,15270,1,0,1
7999,2013,Whitebridge High School,15230,2,2,0
8000,2013,Whitebridge High School,15400,1,0,1
8001,2013,Christian Brothers High School Lewisham,15240,9,9,0
8002,2013,Christian Brothers High School Lewisham,15230,1,1,0
8003,2013,Christian Brothers High School Lewisham,15120,1,1,0
8004,2013,Christian Brothers High School Lewisham,15320,1,1,0
8005,2013,Christian Brothers High School Lewisham,15200,2,2,0
8006,2013,Christian Brothers High School Lewisham,15380,6,6,0
8007,2013,Christian Brothers High School Lewisham,15110,2,2,0
8008,2013,Christian Brothers High School Lewisham,15030,1,1,0
8009,2013,Christian Brothers High School Lewisham,15370,8,8,0
8010,2013,Christian Brothers High School Lewisham,15810,1,1,0
8011,2013,Christian Brothers High School Lewisham,15400,4,4,0
8012,2013,Christian Brothers High School Lewisham,15040,6,6,0
8013,2013,Christian Brothers High School Lewisham,15800,1,1,0
8014,2013,Christian Brothers High School Lewisham,15140,7,7,0
8015,2013,Christian Brothers High School Lewisham,15130,2,2,0
8016,2013,Christian Brothers High School Lewisham,15210,6,6,0
8017,2013,Christian Brothers High School Lewisham,15250,3,3,0
8018,2013,Christian Brothers High School Lewisham,15020,1,1,0
8019,2013,John Therry Catholic High School,15240,1,0,1
8020,2013,John Therry Catholic High School,15270,2,1,1
8021,2013,John Therry Catholic High School,15170,2,1,1
8022,2013,John Therry Catholic High School,15230,3,1,2
8023,2013,John Therry Catholic High School,15190,1,0,1
8024,2013,John Therry Catholic High School,15320,2,1,1
8025,2013,John Therry Catholic High School,15380,3,2,1
8026,2013,John Therry Catholic High School,15260,1,0,1
8027,2013,John Therry Catholic High School,15030,4,2,2
8028,2013,John Therry Catholic High School,15370,2,0,2
8029,2013,John Therry Catholic High School,26599,2,0,2
8030,2013,John Therry Catholic High School,15400,7,1,6
8031,2013,John Therry Catholic High School,15040,1,1,0
8032,2013,John Therry Catholic High School,15180,2,0,2
8033,2013,John Therry Catholic High School,15140,3,1,2
8034,2013,John Therry Catholic High School,15290,2,2,0
8035,2013,John Therry Catholic High School,15250,2,0,2
8036,2013,John Therry Catholic High School,15220,3,2,1
8037,2013,John Therry Catholic High School,15020,1,0,1
8038,2013,Ryde Secondary College,15240,11,6,5
8039,2013,Ryde Secondary College,15270,3,0,3
8040,2013,Ryde Secondary College,15230,1,1,0
8041,2013,Ryde Secondary College,15890,1,1,0
8042,2013,Ryde Secondary College,15550,1,1,0
8043,2013,Ryde Secondary College,15320,1,1,0
8044,2013,Ryde Secondary College,15280,1,0,1
8045,2013,Ryde Secondary College,15820,7,3,4
8046,2013,Ryde Secondary College,15160,1,0,1
8047,2013,Ryde Secondary College,15110,2,0,2
8048,2013,Ryde Secondary College,15560,1,0,1
8049,2013,Ryde Secondary College,15260,7,5,2
8050,2013,Ryde Secondary College,15030,3,2,1
8051,2013,Ryde Secondary College,15310,3,2,1
8052,2013,Ryde Secondary College,15330,2,2,0
8053,2013,Ryde Secondary College,15760,4,2,2
8054,2013,Ryde Secondary College,15400,1,0,1
8055,2013,Ryde Secondary College,15040,5,2,3
8056,2013,Ryde Secondary College,15885,1,1,0
8057,2013,Ryde Secondary College,15050,4,4,0
8058,2013,Ryde Secondary College,15290,1,0,1
8059,2013,Ryde Secondary College,15250,17,12,5
8060,2013,Ryde Secondary College,15220,2,0,2
8061,2013,Ryde Secondary College,15390,1,0,1
8062,2013,Ryde Secondary College,15700,1,0,1
8063,2013,Tweed River High School,15040,1,1,0
8064,2013,Reddam House,15240,19,9,10
8065,2013,Reddam House,15270,4,2,2
8066,2013,Reddam House,15170,1,0,1
8067,2013,Reddam House,15230,14,7,7
8068,2013,Reddam House,16000,1,1,0
8069,2013,Reddam House,15720,1,0,1
8070,2013,Reddam House,15360,1,1,0
8071,2013,Reddam House,15320,2,2,0
8072,2013,Reddam House,15280,2,1,1
8073,2013,Reddam House,15160,2,0,2
8074,2013,Reddam House,15300,3,3,0
8075,2013,Reddam House,15110,3,1,2
8076,2013,Reddam House,15710,1,0,1
8077,2013,Reddam House,15560,1,0,1
8078,2013,Reddam House,15030,2,1,1
8079,2013,Reddam House,15310,2,1,1
8080,2013,Reddam House,15150,1,0,1
8081,2013,Reddam House,15400,8,2,6
8082,2013,Reddam House,15040,14,9,5
8083,2013,Reddam House,15140,13,6,7
8084,2013,Reddam House,15130,2,2,0
8085,2013,Reddam House,15050,2,1,1
8086,2013,Reddam House,15290,1,1,0
8087,2013,Reddam House,15250,5,2,3
8088,2013,Reddam House,15220,9,7,2
8089,2013,Reddam House,15020,3,1,2
8090,2013,Christadelphian Heritage College Sydney,15020,1,1,0
8091,2013,Wyong Christian Community School,15270,1,0,1
8092,2013,Wyong Christian Community School,15230,1,0,1
8093,2013,Wyong Christian Community School,15080,1,1,0
8094,2013,Wyong Christian Community School,15090,1,0,1
8095,2013,Wyong Christian Community School,15160,1,0,1
8096,2013,Wyong Christian Community School,15370,2,0,2
8097,2013,Wyong Christian Community School,15310,1,0,1
8098,2013,West Wyalong High School,15240,3,2,1
8099,2013,West Wyalong High School,15250,2,1,1
8100,2013,West Wyalong High School,15390,1,0,1
8101,2013,Picnic Point High School,15240,1,0,1
8102,2013,Picnic Point High School,15270,1,0,1
8103,2013,Picnic Point High School,15340,1,0,1
8104,2013,Picnic Point High School,15230,3,1,2
8105,2013,Picnic Point High School,15350,1,0,1
8106,2013,Picnic Point High School,15200,1,1,0
8107,2013,Picnic Point High School,15160,2,2,0
8108,2013,Picnic Point High School,15260,1,1,0
8109,2013,Picnic Point High School,15030,1,0,1
8110,2013,Picnic Point High School,15400,1,0,1
8111,2013,Picnic Point High School,15040,3,1,2
8112,2013,Picnic Point High School,15060,2,0,2
8113,2013,Picnic Point High School,15050,1,1,0
8114,2013,Picnic Point High School,15210,1,1,0
8115,2013,Picnic Point High School,15290,1,0,1
8116,2013,Picnic Point High School,15250,2,2,0
8117,2013,Picnic Point High School,15220,2,0,2